"unit","ediScopeUses","ediPackageUses","ediTotalUses","neonScopeUses","neonPackageUses","neonTotalUses","dataoneTotalUses","orgList","numOrgs","totalScopes","totalPackages","TotalUses"
"dimensionless",33,3078,25265,1,1,480,46786,"EDI NEON DataOne",3,34,3079,72531
"number",30,2441,20586,15,59,422,11006,"EDI NEON DataOne",3,45,2500,32014
"percent",26,1599,11280,16,56,11299,3912,"EDI NEON DataOne",3,42,1655,26491
"celsius",33,2126,14154,10,28,733,6389,"EDI NEON DataOne",3,43,2154,21276
"meter",31,2292,7783,20,67,448,3418,"EDI NEON DataOne",3,51,2359,11649
"millimeter",32,1040,3546,6,6,26,5964,"EDI NEON DataOne",3,38,1046,9536
"degree",30,1817,5465,7,10,39,2753,"EDI NEON DataOne",3,37,1827,8257
"centimeter",29,1350,4465,8,11,56,2059,"EDI NEON DataOne",3,37,1361,6580
"gram",27,777,2814,10,19,31,1554,"EDI NEON DataOne",3,37,796,4399
"milligramsperliter",22,382,2347,4,12,19,1006,"EDI NEON DataOne",3,26,394,3372
"meterspersecond",23,312,2036,4,4,73,1159,"EDI NEON DataOne",3,27,316,3268
"none",5,408,2201,9,12,72,299,"EDI NEON DataOne",3,14,420,2572
"nominalday",18,886,1497,5,7,7,745,"EDI NEON DataOne",3,23,893,2249
"volt",23,355,955,1,1,4,901,"EDI NEON DataOne",3,24,356,1860
"microgramsperliter",17,189,886,1,1,6,503,"EDI NEON DataOne",3,18,190,1395
"gramspersquaremeter",20,219,906,3,3,6,424,"EDI NEON DataOne",3,23,222,1336
"hour",17,458,495,3,3,3,528,"EDI NEON DataOne",3,20,461,1026
"kilopascal",19,159,748,5,5,36,189,"EDI NEON DataOne",3,24,164,973
"squaremeter",20,252,475,6,14,15,334,"EDI NEON DataOne",3,26,266,824
"second",14,52,153,2,2,3,605,"EDI NEON DataOne",3,16,54,761
"partspermillion",15,63,422,1,1,150,118,"EDI NEON DataOne",3,16,64,690
"minute",18,79,112,2,2,2,538,"EDI NEON DataOne",3,20,81,652
"day",17,72,108,1,1,1,474,"EDI NEON DataOne",3,18,73,583
"milliliter",24,122,249,5,15,38,118,"EDI NEON DataOne",3,29,137,405
"nominalhour",8,214,271,1,1,1,113,"EDI NEON DataOne",3,9,215,385
"milligramsperkilogram",6,72,189,2,2,21,160,"EDI NEON DataOne",3,8,74,370
"cubicmeter",12,69,206,2,2,3,133,"EDI NEON DataOne",3,14,71,342
"wattspersquaremeter",5,25,123,4,6,154,18,"EDI NEON DataOne",3,9,31,295
"microsiemenspercentimeter",11,91,135,5,15,71,31,"EDI NEON DataOne",3,16,106,237
"gramspercubiccentimeter",21,108,152,2,2,4,80,"EDI NEON DataOne",3,23,110,236
"ph",10,130,167,3,5,13,42,"EDI NEON DataOne",3,13,135,222
"literspersecond",9,65,149,2,3,26,29,"EDI NEON DataOne",3,11,68,204
"milligramspercubicmeter",7,13,31,1,1,80,74,"EDI NEON DataOne",3,8,14,185
"micromolespersquaremeterpersecond",6,14,17,3,4,140,13,"EDI NEON DataOne",3,9,18,170
"gramspergram",9,34,105,1,1,1,49,"EDI NEON DataOne",3,10,35,155
"micromolesperliter",4,11,42,1,1,6,74,"EDI NEON DataOne",3,5,12,122
"liter",15,51,73,2,5,7,14,"EDI NEON DataOne",3,17,56,94
"nanometer",12,35,59,1,1,4,19,"EDI NEON DataOne",3,13,36,82
"gramsperkilogram",7,16,47,2,2,16,7,"EDI NEON DataOne",3,9,18,70
"kilometersperhour",8,15,21,1,1,1,46,"EDI NEON DataOne",3,9,16,68
"proportion",7,19,60,1,1,3,4,"EDI NEON DataOne",3,8,20,67
"gramspercubicmeter",2,3,23,1,1,1,33,"EDI NEON DataOne",3,3,4,57
"millimolesperliter",2,3,5,2,2,28,1,"EDI NEON DataOne",3,4,5,34
"meterssquared",3,10,10,2,3,11,8,"EDI NEON DataOne",3,5,13,29
"meterspersecondsquared",2,3,7,3,3,14,4,"EDI NEON DataOne",3,5,6,25
"microgramspermilliliter",3,4,18,1,1,3,4,"EDI NEON DataOne",3,4,5,25
"squarecentimeter",2,3,18,1,1,1,5,"EDI NEON DataOne",3,3,4,24
"hertz",2,3,4,1,1,4,2,"EDI NEON DataOne",3,3,4,10
"siemenspercentimeter",3,3,4,2,2,2,2,"EDI NEON DataOne",3,5,5,8
"meters per second",1,4,24,0,0,0,26349,"EDI DataOne",2,1,4,26373
"grampermetersquared",13,171,3534,0,0,0,409,"EDI DataOne",2,13,171,3943
"nominalyear",17,1204,2105,0,0,0,788,"EDI DataOne",2,17,1204,2893
"wattpermetersquared",17,174,2349,0,0,0,428,"EDI DataOne",2,17,174,2777
"grampermetersquaredperday",5,37,2399,0,0,0,92,"EDI DataOne",2,5,37,2491
"meterpersecond",15,270,2043,0,0,0,202,"EDI DataOne",2,15,270,2245
"micromolepermetersquaredpersecond",17,246,1594,0,0,0,549,"EDI DataOne",2,17,246,2143
"hectare",12,96,1636,0,0,0,264,"EDI DataOne",2,12,96,1900
"micromoleperliter",15,233,1403,0,0,0,417,"EDI DataOne",2,15,233,1820
"kilogrampercubicmeter",8,315,1373,0,0,0,406,"EDI DataOne",2,8,315,1779
"decibar",9,307,1342,0,0,0,403,"EDI DataOne",2,9,307,1745
"siemenspermeter",5,368,1329,0,0,0,356,"EDI DataOne",2,5,368,1685
"milligramperliter",15,270,1189,0,0,0,423,"EDI DataOne",2,15,270,1612
"meters",5,51,267,0,0,0,1149,"EDI DataOne",2,5,51,1416
"nominalmonth",5,593,883,0,0,0,299,"EDI DataOne",2,5,593,1182
"numberpermetersquared",20,151,837,0,0,0,325,"EDI DataOne",2,20,151,1162
"microgramperliter",13,142,713,0,0,0,430,"EDI DataOne",2,13,142,1143
"degrees celsius",1,10,56,0,0,0,943,"EDI DataOne",2,1,10,999
"kilogramsperhectare",7,40,670,0,0,0,253,"EDI DataOne",2,7,40,923
"cubicmeterpercubicmeter",3,80,895,0,0,0,5,"EDI DataOne",2,3,80,900
"percentabbr.",1,95,709,0,0,0,141,"EDI DataOne",2,1,95,850
"count",8,39,377,0,0,0,469,"EDI DataOne",2,8,39,846
"unitless",5,23,98,0,0,0,738,"EDI DataOne",2,5,23,836
"fraction",4,19,450,0,0,0,358,"EDI DataOne",2,4,19,808
"degc",1,22,679,0,0,0,126,"EDI DataOne",2,1,22,805
"decisiemenspermeter",1,76,627,2,2,4,0,"EDI NEON",2,3,78,631
"year",8,65,130,0,0,0,484,"EDI DataOne",2,8,65,614
"gramperfourhundredthmetersquared",1,21,390,0,0,0,197,"EDI DataOne",2,1,21,587
"degrees",5,122,270,0,0,0,314,"EDI DataOne",2,5,122,584
"inches",2,3,15,0,0,0,567,"EDI DataOne",2,2,3,582
"metercubedpersecond",6,46,524,0,0,0,28,"EDI DataOne",2,6,46,552
"gramspermetersquaredperyear",8,153,269,0,0,0,269,"EDI DataOne",2,8,153,538
"percentage",7,27,255,0,0,0,263,"EDI DataOne",2,7,27,518
"practicalsalinityunit",5,33,452,0,0,0,54,"EDI DataOne",2,5,33,506
"kilogram",18,69,266,0,0,0,236,"EDI DataOne",2,18,69,502
"# kg/soil",1,9,339,0,0,0,161,"EDI DataOne",2,1,9,500
"decimal degrees",2,5,14,0,0,0,477,"EDI DataOne",2,2,5,491
"na",0,0,0,15,39,181,296,"NEON DataOne",2,15,39,477
"microequivalentperliter",6,53,398,0,0,0,72,"EDI DataOne",2,6,53,470
"microgramspergram",17,87,358,0,0,0,108,"EDI DataOne",2,17,87,466
"foot",20,110,215,0,0,0,237,"EDI DataOne",2,20,110,452
"milligram",22,108,348,0,0,0,103,"EDI DataOne",2,22,108,451
"month",4,11,14,0,0,0,434,"EDI DataOne",2,4,11,448
"numberperhectare",6,26,210,0,0,0,229,"EDI DataOne",2,6,26,439
"1",1,1,1,0,0,0,426,"EDI DataOne",2,1,1,427
"numberpermetercubed",6,18,357,0,0,0,69,"EDI DataOne",2,6,18,426
"grampermetersquaredperyear",8,21,311,0,0,0,105,"EDI DataOne",2,8,21,416
"millibar",23,172,297,0,0,0,115,"EDI DataOne",2,23,172,412
"milligrampergram",10,49,338,0,0,0,61,"EDI DataOne",2,10,49,399
"inch",21,69,202,0,0,0,167,"EDI DataOne",2,21,69,369
"microgrampergram",12,53,284,0,0,0,85,"EDI DataOne",2,12,53,369
"micromolesperliter",9,43,228,0,0,0,132,"EDI DataOne",2,9,43,360
"numberperliter",7,27,186,0,0,0,168,"EDI DataOne",2,7,27,354
"millimolepermetersquaredpersecond",6,46,280,0,0,0,72,"EDI DataOne",2,6,46,352
"squarecentimeters",16,115,220,0,0,0,124,"EDI DataOne",2,16,115,344
"nominalminute",7,198,247,0,0,0,90,"EDI DataOne",2,7,198,337
"w/m^2",2,32,315,0,0,0,22,"EDI DataOne",2,2,32,337
"w/m2",3,52,272,0,0,0,52,"EDI DataOne",2,3,52,324
"centimeters",4,46,237,0,0,0,87,"EDI DataOne",2,4,46,324
"grampergram",8,49,304,0,0,0,16,"EDI DataOne",2,8,49,320
"parts per million",2,6,57,0,0,0,262,"EDI DataOne",2,2,6,319
"milligramspergram",11,51,198,0,0,0,118,"EDI DataOne",2,11,51,316
"micrometer",15,29,232,0,0,0,64,"EDI DataOne",2,15,29,296
"partperthousand",7,135,236,0,0,0,49,"EDI DataOne",2,7,135,285
"percentage",1,1,2,0,0,0,279,"EDI DataOne",2,1,1,281
"phi",1,1,5,0,0,0,276,"EDI DataOne",2,1,1,281
"millimeterperday",7,35,245,0,0,0,35,"EDI DataOne",2,7,35,280
"squarekilometers",10,29,139,0,0,0,141,"EDI DataOne",2,10,29,280
"permil",14,85,249,0,0,0,27,"EDI DataOne",2,14,85,276
"metercubedpermetercubed",4,52,238,0,0,0,30,"EDI DataOne",2,4,52,268
"fahrenheit",16,46,179,0,0,0,76,"EDI DataOne",2,16,46,255
"micromoleperkilogram",6,57,227,0,0,0,27,"EDI DataOne",2,6,57,254
"milligramperkilogram",12,46,215,0,0,0,37,"EDI DataOne",2,12,46,252
"kilometer",16,69,115,0,0,0,132,"EDI DataOne",2,16,69,247
"micromolepermole",8,76,206,0,0,0,34,"EDI DataOne",2,8,76,240
"partsperthousand",9,59,220,0,0,0,19,"EDI DataOne",2,9,59,239
"kilogrampermetercubed",8,60,181,0,0,0,50,"EDI DataOne",2,8,60,231
"microsiemenpercentimeter",5,105,140,0,0,0,87,"EDI DataOne",2,5,105,227
"mole",5,7,17,0,0,0,206,"EDI DataOne",2,5,7,223
"year (yyyy)",1,103,172,0,0,0,47,"EDI DataOne",2,1,103,219
"metersquared",16,86,188,0,0,0,24,"EDI DataOne",2,16,86,212
"effortpergram",1,25,201,0,0,0,9,"EDI DataOne",2,1,25,210
"microsiemenpercentimeter",5,49,186,0,0,0,23,"EDI DataOne",2,5,49,209
"decimaldegree",4,26,58,17,56,148,0,"EDI NEON",2,21,82,206
"watt",1,1,2,0,0,0,203,"EDI DataOne",2,1,1,205
"microgram",17,49,158,0,0,0,46,"EDI DataOne",2,17,49,204
"hhhh",1,33,152,0,0,0,52,"EDI DataOne",2,1,33,204
"percent",3,6,20,0,0,0,182,"EDI DataOne",2,3,6,202
"millimeters",5,22,101,0,0,0,100,"EDI DataOne",2,5,22,201
"acre",9,48,119,0,0,0,78,"EDI DataOne",2,9,48,197
"milliliterperliter",4,89,160,0,0,0,33,"EDI DataOne",2,4,89,193
"ppm",5,18,152,0,0,0,40,"EDI DataOne",2,5,18,192
"megapascal",7,45,180,0,0,0,10,"EDI DataOne",2,7,45,190
"%",4,12,24,0,0,0,166,"EDI DataOne",2,4,12,190
"metersquaredpermetersquared",3,47,129,0,0,0,59,"EDI DataOne",2,3,47,188
"dollar",3,3,47,0,0,0,141,"EDI DataOne",2,3,3,188
"grams",5,29,74,0,0,0,111,"EDI DataOne",2,5,29,185
"millivolt",15,46,98,0,0,0,83,"EDI DataOne",2,15,46,181
"cubicmeterspersecond",9,40,155,0,0,0,25,"EDI DataOne",2,9,40,180
"meterssquaredperhectare",1,1,59,0,0,0,120,"EDI DataOne",2,1,1,179
"milligrampermetersquaredperday",12,50,109,0,0,0,67,"EDI DataOne",2,12,50,176
"cm",1,33,92,0,0,0,83,"EDI DataOne",2,1,33,175
"millimolepermetercubed",4,33,160,0,0,0,15,"EDI DataOne",2,4,33,175
"milligrams per liter",2,7,148,0,0,0,26,"EDI DataOne",2,2,7,174
"pascal",10,27,158,0,0,0,14,"EDI DataOne",2,10,27,172
"gramspermetersquared",5,46,64,0,0,0,105,"EDI DataOne",2,5,46,169
"microeinsteinpermetersquaredpersecond",4,40,136,0,0,0,31,"EDI DataOne",2,4,40,167
"numberpermilliliter",11,33,125,0,0,0,38,"EDI DataOne",2,11,33,163
"joule",1,2,2,0,0,0,157,"EDI DataOne",2,1,2,159
"milligramspersquaremeter",12,26,96,0,0,0,60,"EDI DataOne",2,12,26,156
"decisiemenspermeter",1,9,104,0,0,0,47,"EDI DataOne",2,1,9,151
"literpersecond",7,108,136,0,0,0,13,"EDI DataOne",2,7,108,149
"partpermillion",6,49,143,0,0,0,5,"EDI DataOne",2,6,49,148
"milligrampermetercubedperday",4,24,133,0,0,0,15,"EDI DataOne",2,4,24,148
"milliliterperthousandcubicmeter",2,4,74,0,0,0,72,"EDI DataOne",2,2,4,146
"numberperthousandmeterscubed",1,3,77,0,0,0,68,"EDI DataOne",2,1,3,145
"feet",6,21,50,0,0,0,93,"EDI DataOne",2,6,21,143
"milligrampermetersquared",7,26,99,0,0,0,41,"EDI DataOne",2,7,26,140
"millisiemenpercentimeter",7,79,122,0,0,0,17,"EDI DataOne",2,7,79,139
"celsiussquared",1,1,1,7,11,137,0,"EDI NEON",2,8,12,138
"tonne",2,2,8,0,0,0,129,"EDI DataOne",2,2,2,137
"mm",2,3,80,0,0,0,53,"EDI DataOne",2,2,3,133
"pound",5,10,17,0,0,0,113,"EDI DataOne",2,5,10,130
"centimetersquared",12,47,111,0,0,0,18,"EDI DataOne",2,12,47,129
"micrometersquared",2,7,121,0,0,0,3,"EDI DataOne",2,2,7,124
"yyyy",1,70,77,0,0,0,46,"EDI DataOne",2,1,70,123
"micromoleperliter",3,6,61,0,0,0,60,"EDI DataOne",2,3,6,121
"metersquaredperhectare",4,20,89,0,0,0,26,"EDI DataOne",2,4,20,115
"wattspermetersquared",8,20,81,0,0,0,34,"EDI DataOne",2,8,20,115
"g m-2",1,1,1,0,0,0,114,"EDI DataOne",2,1,1,115
"cubiccentimeterspercubiccentimeters",8,15,72,0,0,0,42,"EDI DataOne",2,8,15,114
"reciprocalmeter",4,55,108,0,0,0,4,"EDI DataOne",2,4,55,112
"meterperday",4,29,108,0,0,0,4,"EDI DataOne",2,4,29,112
"centimeterspersecond",8,20,65,0,0,0,46,"EDI DataOne",2,8,20,111
"milligrampermetersquaredperhour",4,15,68,0,0,0,43,"EDI DataOne",2,4,15,111
"year (yyyy)",1,19,107,0,0,0,3,"EDI DataOne",2,1,19,110
"centimeterpersecond",9,30,100,0,0,0,9,"EDI DataOne",2,9,30,109
"days",6,15,29,0,0,0,79,"EDI DataOne",2,6,15,108
"kgbiomass/tree/year",1,10,68,0,0,0,40,"EDI DataOne",2,1,10,108
"microatmosphere",7,34,88,0,0,0,17,"EDI DataOne",2,7,34,105
"celsius",4,8,42,0,0,0,62,"EDI DataOne",2,4,8,104
"kelvin",9,54,81,0,0,0,21,"EDI DataOne",2,9,54,102
"grampermetercubed",5,32,85,0,0,0,15,"EDI DataOne",2,5,32,100
"n/a",1,2,98,0,0,0,1,"EDI DataOne",2,1,2,99
"integer",1,3,53,0,0,0,45,"EDI DataOne",2,1,3,98
"microeinsteinspersquaremeter",1,67,67,0,0,0,29,"EDI DataOne",2,1,67,96
"microsiemens/cm",3,39,85,0,0,0,10,"EDI DataOne",2,3,39,95
"knots",3,20,85,0,0,0,10,"EDI DataOne",2,3,20,95
"microequivalentsperliter",3,16,87,0,0,0,8,"EDI DataOne",2,3,16,95
"metersquaredpersecondsquared",3,32,83,0,0,0,11,"EDI DataOne",2,3,32,94
"metercubedperhectare",4,8,37,0,0,0,55,"EDI DataOne",2,4,8,92
"metersbelowlandsurface",1,2,69,0,0,0,23,"EDI DataOne",2,1,2,92
"micromolespersquaremeterpersecond",3,5,30,0,0,0,61,"EDI DataOne",2,3,5,91
"kilogrampermetersquaredpersecond",1,30,79,0,0,0,11,"EDI DataOne",2,1,30,90
"microsiemenspercentimeter",8,51,77,0,0,0,11,"EDI DataOne",2,8,51,88
"milligrampermetercubed",4,37,58,0,0,0,30,"EDI DataOne",2,4,37,88
"gramspersquaremeterperday",3,5,35,0,0,0,53,"EDI DataOne",2,3,5,88
"micromols/second/meter2",1,23,80,0,0,0,7,"EDI DataOne",2,1,23,87
"m",2,16,28,0,0,0,59,"EDI DataOne",2,2,16,87
"nanogramsperliter",2,2,23,0,0,0,64,"EDI DataOne",2,2,2,87
"mmol/m2/s",1,8,49,0,0,0,37,"EDI DataOne",2,1,8,86
"cubicmeterperkilogram",2,35,84,0,0,0,1,"EDI DataOne",2,2,35,85
"microsecond",5,25,64,0,0,0,19,"EDI DataOne",2,5,25,83
"cubicmeterperhectare",2,2,26,0,0,0,54,"EDI DataOne",2,2,2,80
"grampercentimetercubed",9,46,70,0,0,0,9,"EDI DataOne",2,9,46,79
"ratio",7,20,48,0,0,0,31,"EDI DataOne",2,7,20,79
"years",4,10,44,0,0,0,35,"EDI DataOne",2,4,10,79
"gallon",4,7,11,0,0,0,67,"EDI DataOne",2,4,7,78
"kilogramspersquaremeter",7,18,38,0,0,0,39,"EDI DataOne",2,7,18,77
"microgrampergramperday",7,16,74,0,0,0,2,"EDI DataOne",2,7,16,76
"1e6dollars",1,1,19,0,0,0,57,"EDI DataOne",2,1,1,76
"acres",1,1,1,0,0,0,75,"EDI DataOne",2,1,1,76
"kilowattpermetersquared",6,31,47,0,0,0,28,"EDI DataOne",2,6,31,75
"micromolepergramperhour",6,15,62,0,0,0,13,"EDI DataOne",2,6,15,75
"n/a",2,5,14,0,0,0,61,"EDI DataOne",2,2,5,75
"numberperfivecentimeter",1,1,74,0,0,0,1,"EDI DataOne",2,1,1,75
"microgramperliterperday",4,36,50,0,0,0,24,"EDI DataOne",2,4,36,74
"centimoleperkilogram",5,9,58,0,0,0,16,"EDI DataOne",2,5,9,74
"microgramspermilligram",5,6,70,0,0,0,4,"EDI DataOne",2,5,6,74
"cm3/cm3",1,4,55,0,0,0,19,"EDI DataOne",2,1,4,74
"kilogrampermetersquared",9,18,52,0,0,0,21,"EDI DataOne",2,9,18,73
"gm-2",1,2,2,0,0,0,70,"EDI DataOne",2,1,2,72
"permil",5,23,59,0,0,0,12,"EDI DataOne",2,5,23,71
"micrograms per liter",1,3,3,0,0,0,67,"EDI DataOne",2,1,3,70
"millimolepermetersquared",1,29,58,0,0,0,11,"EDI DataOne",2,1,29,69
"mile",8,19,37,0,0,0,32,"EDI DataOne",2,8,19,69
"gramsperhectograms",1,8,23,0,0,0,46,"EDI DataOne",2,1,8,69
"period",1,4,39,0,0,0,30,"EDI DataOne",2,1,4,69
"disintegrationsperminute",1,24,48,0,0,0,20,"EDI DataOne",2,1,24,68
"millimolepermole",6,24,60,0,0,0,7,"EDI DataOne",2,6,24,67
"microeinsteinspersquaremeterpersecond",3,37,50,0,0,0,16,"EDI DataOne",2,3,37,66
"millimolespersquaremeter",5,31,52,0,0,0,14,"EDI DataOne",2,5,31,66
"g",2,17,32,0,0,0,34,"EDI DataOne",2,2,17,66
"millimolepermetersquaredperday",7,15,61,0,0,0,5,"EDI DataOne",2,7,15,66
"squaremillimeters",6,16,55,0,0,0,10,"EDI DataOne",2,6,16,65
"ntu",3,11,55,0,0,0,10,"EDI DataOne",2,3,11,65
"meterpersecond",1,3,41,0,0,0,24,"EDI DataOne",2,1,3,65
"millimoles/liter",1,9,59,0,0,0,5,"EDI DataOne",2,1,9,64
"seconds",2,6,11,0,0,0,53,"EDI DataOne",2,2,6,64
"gramsper100grams",1,21,21,0,0,0,42,"EDI DataOne",2,1,21,63
"unitless",1,1,48,0,0,0,15,"EDI DataOne",2,1,1,63
"milesperhour",6,15,39,0,0,0,23,"EDI DataOne",2,6,15,62
"partsperbillion",5,13,55,0,0,0,7,"EDI DataOne",2,5,13,62
"bar",5,7,23,0,0,0,39,"EDI DataOne",2,5,7,62
"decimal degrees latitude or longitude",4,25,57,0,0,0,4,"EDI DataOne",2,4,25,61
"microgramsperkilogram",2,2,13,0,0,0,48,"EDI DataOne",2,2,2,61
"psu",3,29,32,0,0,0,28,"EDI DataOne",2,3,29,60
"metercubed",6,20,57,0,0,0,3,"EDI DataOne",2,6,20,60
"1e3dollars",1,1,15,0,0,0,45,"EDI DataOne",2,1,1,60
"metersquaredpersecond",3,21,52,0,0,0,7,"EDI DataOne",2,3,21,59
"kilogramperhectare",6,8,42,0,0,0,17,"EDI DataOne",2,6,8,59
"nanomolespergram",1,1,2,1,1,57,0,"EDI NEON",2,2,2,59
"microequivalentsperliter",2,13,47,0,0,0,11,"EDI DataOne",2,2,13,58
"decimal degrees",2,2,4,0,0,0,54,"EDI DataOne",2,2,2,58
"dimmessionless",1,2,21,0,0,0,37,"EDI DataOne",2,1,2,58
"nanomolepergramperhour",3,4,56,0,0,0,1,"EDI DataOne",2,3,4,57
"standardizedunits",1,1,28,0,0,0,28,"EDI DataOne",2,1,1,56
"nanomolespergrampersecond",3,6,13,0,0,0,42,"EDI DataOne",2,3,6,55
"tonneperhectare",4,6,16,0,0,0,39,"EDI DataOne",2,4,6,55
"nephelometricturbidityunit",6,31,52,0,0,0,2,"EDI DataOne",2,6,31,54
"micromolar",3,10,52,0,0,0,2,"EDI DataOne",2,3,10,54
"m/s",1,2,40,0,0,0,14,"EDI DataOne",2,1,2,54
"centimetercubed",7,19,43,0,0,0,10,"EDI DataOne",2,7,19,53
"millimeterperyear",7,15,40,0,0,0,12,"EDI DataOne",2,7,15,52
"decimal degree",1,13,32,0,0,0,20,"EDI DataOne",2,1,13,52
"square meters",2,7,12,0,0,0,40,"EDI DataOne",2,2,7,52
"micromolespergramperhour",3,6,42,0,0,0,10,"EDI DataOne",2,3,6,52
"relativefluorescenceunit",2,6,50,0,0,0,2,"EDI DataOne",2,2,6,52
"wattspermeter",1,4,26,0,0,0,25,"EDI DataOne",2,1,4,51
"wattpersquaremeter",1,1,3,0,0,0,48,"EDI DataOne",2,1,1,51
"henry",1,8,34,0,0,0,16,"EDI DataOne",2,1,8,50
"milligrampermetersquareperhour",1,5,34,0,0,0,16,"EDI DataOne",2,1,5,50
"mg/l",1,2,15,0,0,0,35,"EDI DataOne",2,1,2,50
"kilogramsperhectareperyear",6,16,46,0,0,0,3,"EDI DataOne",2,6,16,49
"microgramspergramperday",6,13,35,0,0,0,14,"EDI DataOne",2,6,13,49
"decibel",2,2,12,0,0,0,37,"EDI DataOne",2,2,2,49
"parts per million (ppm)",1,1,3,0,0,0,46,"EDI DataOne",2,1,1,49
"degreesfromnorth",1,17,34,0,0,0,14,"EDI DataOne",2,1,17,48
"molarity",4,4,21,0,0,0,27,"EDI DataOne",2,4,4,48
"millisecond",5,6,32,0,0,0,15,"EDI DataOne",2,5,6,47
"cubicfeetpersecond",7,16,35,0,0,0,11,"EDI DataOne",2,7,16,46
"knot",4,13,37,0,0,0,9,"EDI DataOne",2,4,13,46
"microatmosphere",2,8,31,0,0,0,15,"EDI DataOne",2,2,8,46
"um",3,6,32,0,0,0,14,"EDI DataOne",2,3,6,46
"nanogramspergram",1,3,23,0,0,0,23,"EDI DataOne",2,1,3,46
"m",1,1,1,0,0,0,45,"EDI DataOne",2,1,1,46
"megajoulepermetersquared",3,22,33,0,0,0,12,"EDI DataOne",2,3,22,45
"datetime",1,16,33,0,0,0,12,"EDI DataOne",2,1,16,45
"numberperkilometersquared",5,7,16,0,0,0,29,"EDI DataOne",2,5,7,45
"cubicmeterspercubicmeters",1,2,4,0,0,0,41,"EDI DataOne",2,1,2,45
"degrees latitude or longitude",4,17,38,0,0,0,6,"EDI DataOne",2,4,17,44
"microm",1,9,38,0,0,0,6,"EDI DataOne",2,1,9,44
"cubic feet per second",2,3,26,0,0,0,18,"EDI DataOne",2,2,3,44
"numberpercentimetersquared",2,3,43,0,0,0,1,"EDI DataOne",2,2,3,44
"micromolepermeterpersecondsquared",1,14,37,0,0,0,6,"EDI DataOne",2,1,14,43
"gco2-cm-2half-hour-1",1,4,14,0,0,0,29,"EDI DataOne",2,1,4,43
"millimolesperkilogram",1,4,28,0,0,0,15,"EDI DataOne",2,1,4,43
"gramperonetenthmetersquared",3,3,25,0,0,0,18,"EDI DataOne",2,3,3,43
"kilometersquared",5,15,41,0,0,0,1,"EDI DataOne",2,5,15,42
"centemeter",1,2,28,0,0,0,14,"EDI DataOne",2,1,2,42
"m2/m2",1,1,21,0,0,0,21,"EDI DataOne",2,1,1,42
"onetenthinch",1,1,21,0,0,0,21,"EDI DataOne",2,1,1,42
"year",6,12,23,0,0,0,18,"EDI DataOne",2,6,12,41
"micromolesperkilogram",2,6,24,0,0,0,17,"EDI DataOne",2,2,6,41
"millimolespercubicmeter",3,3,26,0,0,0,15,"EDI DataOne",2,3,3,41
"cm3/cm2",1,2,35,0,0,0,6,"EDI DataOne",2,1,2,41
"megajoulepermetersquaredperday",1,35,37,0,0,0,3,"EDI DataOne",2,1,35,40
"kilogrampermeterpersecondsquared",2,19,38,0,0,0,2,"EDI DataOne",2,2,19,40
"millimolespermetercubed",1,1,20,0,0,0,20,"EDI DataOne",2,1,1,40
"count",3,19,23,0,0,0,16,"EDI DataOne",2,3,19,39
"numberpergram",7,10,31,0,0,0,8,"EDI DataOne",2,7,10,39
"molepermetersquaredperday",5,26,35,0,0,0,3,"EDI DataOne",2,5,26,38
"g/m2",1,5,15,0,0,0,23,"EDI DataOne",2,1,5,38
"kilogrampermetersquaredperday",1,2,30,0,0,0,8,"EDI DataOne",2,1,2,38
"microomhn/cm",1,1,1,0,0,0,37,"EDI DataOne",2,1,1,38
"no units",1,1,1,0,0,0,37,"EDI DataOne",2,1,1,38
"degreecelsius",2,12,31,0,0,0,6,"EDI DataOne",2,2,12,37
"joulepermetercubedperkelvin",1,29,29,0,0,0,7,"EDI DataOne",2,1,29,36
"molepermetersquaredpersecond",6,12,28,0,0,0,8,"EDI DataOne",2,6,12,36
"reciprocalmeterpersteradian",1,9,27,0,0,0,9,"EDI DataOne",2,1,9,36
"micromolespermetersquaredpersecond",5,7,28,0,0,0,8,"EDI DataOne",2,5,7,36
"kilogramsperhectareperday",2,2,18,0,0,0,18,"EDI DataOne",2,2,2,36
"cfu/g",1,1,12,0,0,0,24,"EDI DataOne",2,1,1,36
"ohm",1,1,12,0,0,0,24,"EDI DataOne",2,1,1,36
"reciprocalday",1,1,12,0,0,0,24,"EDI DataOne",2,1,1,36
"radian",4,31,31,0,0,0,4,"EDI DataOne",2,4,31,35
"microgramspergramperhour",4,7,23,0,0,0,12,"EDI DataOne",2,4,7,35
"micromolespermeterssquaredpersecond",1,6,24,0,0,0,11,"EDI DataOne",2,1,6,35
"gramsperhectogram",2,5,21,0,0,0,14,"EDI DataOne",2,2,5,35
"kilojoulepermetersquare",1,18,29,0,0,0,5,"EDI DataOne",2,1,18,34
"degrees celcius",1,11,27,0,0,0,7,"EDI DataOne",2,1,11,34
"nominalweek",3,5,14,0,0,0,20,"EDI DataOne",2,3,5,34
"integer",1,1,1,0,0,0,33,"EDI DataOne",2,1,1,34
"poundsperacre",1,1,8,0,0,0,26,"EDI DataOne",2,1,1,34
"numberpercentimetercubed",2,21,26,0,0,0,7,"EDI DataOne",2,2,21,33
"perday",5,7,30,0,0,0,3,"EDI DataOne",2,5,7,33
"celcius",6,10,23,0,0,0,9,"EDI DataOne",2,6,10,32
"permeter",6,7,25,0,0,0,7,"EDI DataOne",2,6,7,32
"milligramspergramperday",2,3,15,0,0,0,17,"EDI DataOne",2,2,3,32
"milligramspergramperhour",1,3,11,0,0,0,21,"EDI DataOne",2,1,3,32
"years",2,3,8,0,0,0,24,"EDI DataOne",2,2,3,32
"milligramsperkilogram",1,2,16,0,0,0,16,"EDI DataOne",2,1,2,32
"hectares",3,12,12,0,0,0,19,"EDI DataOne",2,3,12,31
"gramperliter",4,6,8,0,0,0,23,"EDI DataOne",2,4,6,31
"minutes of a degree",2,5,19,0,0,0,12,"EDI DataOne",2,2,5,31
"megagramperhectareperyear",2,2,9,0,0,0,22,"EDI DataOne",2,2,2,31
"degreec",1,1,30,0,0,0,1,"EDI DataOne",2,1,1,31
"micromolespercubiccentimeter",1,1,10,0,0,0,21,"EDI DataOne",2,1,1,31
"siemen",2,5,7,0,0,0,23,"EDI DataOne",2,2,5,30
"percent (%)",1,1,3,0,0,0,27,"EDI DataOne",2,1,1,30
"meterpermetersquared",2,27,28,0,0,0,1,"EDI DataOne",2,2,27,29
"us/cm",3,11,11,0,0,0,18,"EDI DataOne",2,3,11,29
"micromolepermetersquaredperhour",3,7,22,0,0,0,7,"EDI DataOne",2,3,7,29
"grams per square meter per day",2,3,15,0,0,0,14,"EDI DataOne",2,2,3,29
"micromolepermetersquaredperday",9,11,27,0,0,0,1,"EDI DataOne",2,9,11,28
"moleperkilogram",2,4,23,0,0,0,5,"EDI DataOne",2,2,4,28
"cm2/m2",1,3,23,0,0,0,5,"EDI DataOne",2,1,3,28
"centimolesperkilogram",1,2,14,0,0,0,14,"EDI DataOne",2,1,2,28
"gg-1",1,2,24,0,0,0,4,"EDI DataOne",2,1,2,28
"joulepercentimetersquared",2,2,23,0,0,0,5,"EDI DataOne",2,2,2,28
"kilowatthour",2,2,10,0,0,0,18,"EDI DataOne",2,2,2,28
"ha",1,1,14,0,0,0,14,"EDI DataOne",2,1,1,28
"nanomolespercentimetersquared",1,1,9,0,0,0,19,"EDI DataOne",2,1,1,28
"ph units",3,16,24,0,0,0,3,"EDI DataOne",2,3,16,27
"megagramsperhectare",3,10,24,0,0,0,3,"EDI DataOne",2,3,10,27
"mg/l",2,6,13,0,0,0,14,"EDI DataOne",2,2,6,27
"countpermetersquared",2,4,15,0,0,0,12,"EDI DataOne",2,2,4,27
"numberperkilogram",3,4,26,0,0,0,1,"EDI DataOne",2,3,4,27
"hpa",1,1,2,0,0,0,25,"EDI DataOne",2,1,1,27
"kilowattpermetersquare",1,16,21,0,0,0,5,"EDI DataOne",2,1,16,26
"bushelsperacre",2,9,15,0,0,0,11,"EDI DataOne",2,2,9,26
"microequivalentperliter",1,5,14,0,0,0,12,"EDI DataOne",2,1,5,26
"number of years",1,5,25,0,0,0,1,"EDI DataOne",2,1,5,26
"micromolar",3,4,13,0,0,0,13,"EDI DataOne",2,3,4,26
"nanomolespergramperhour",4,4,20,0,0,0,6,"EDI DataOne",2,4,4,26
"stems/m2",1,2,20,0,0,0,6,"EDI DataOne",2,1,2,26
"mole percent",1,1,15,0,0,0,11,"EDI DataOne",2,1,1,26
"dd",2,11,11,0,0,0,14,"EDI DataOne",2,2,11,25
"poundspersquareinch",4,11,22,0,0,0,3,"EDI DataOne",2,4,11,25
"millisiemenspercentimeter",6,9,21,0,0,0,4,"EDI DataOne",2,6,9,25
"microgrampermetersquaredperhour",4,5,17,0,0,0,8,"EDI DataOne",2,4,5,25
"micromolespermole",4,5,10,0,0,0,15,"EDI DataOne",2,4,5,25
"minutes",2,5,9,0,0,0,16,"EDI DataOne",2,2,5,25
"percmx1000",1,5,23,0,0,0,2,"EDI DataOne",2,1,5,25
"micromolespermole",2,4,17,0,0,0,8,"EDI DataOne",2,2,4,25
"millimolespersquaremeterperday",2,4,23,0,0,0,2,"EDI DataOne",2,2,4,25
"cubicfeetpersecondpersquaremile",1,2,6,0,0,0,19,"EDI DataOne",2,1,2,25
"ppmv",2,2,23,0,0,0,2,"EDI DataOne",2,2,2,25
"micromolespergrampersecond",1,1,1,0,0,0,24,"EDI DataOne",2,1,1,25
"micron",5,8,18,0,0,0,6,"EDI DataOne",2,5,8,24
"ton",4,7,10,0,0,0,14,"EDI DataOne",2,4,7,24
"numberpermeter",3,6,14,0,0,0,10,"EDI DataOne",2,3,6,24
"milligramspercubiccentimeter",4,5,17,0,0,0,7,"EDI DataOne",2,4,5,24
"ppb",2,5,23,0,0,0,1,"EDI DataOne",2,2,5,24
"qsupermilligramperliter",1,5,13,0,0,0,11,"EDI DataOne",2,1,5,24
"seconds of a degree",2,5,15,0,0,0,9,"EDI DataOne",2,2,5,24
"foot_us",2,3,6,0,0,0,18,"EDI DataOne",2,2,3,24
"milliequivalentsper100grams",1,3,23,0,0,0,1,"EDI DataOne",2,1,3,24
"meterdays",1,2,18,0,0,0,6,"EDI DataOne",2,1,2,24
"parts per billion",1,2,5,0,0,0,19,"EDI DataOne",2,1,2,24
"phunits",1,2,2,0,0,0,22,"EDI DataOne",2,1,2,24
"isotope",1,1,12,0,0,0,12,"EDI DataOne",2,1,1,24
"millivolts",1,1,2,0,0,0,22,"EDI DataOne",2,1,1,24
"none",1,1,1,0,0,0,23,"EDI DataOne",2,1,1,24
"micromole",4,9,21,0,0,0,2,"EDI DataOne",2,4,9,23
"day",2,8,8,0,0,0,15,"EDI DataOne",2,2,8,23
"millimolespersquaremeterpersecond",3,7,15,0,0,0,8,"EDI DataOne",2,3,7,23
"%dryweight",1,4,11,0,0,0,12,"EDI DataOne",2,1,4,23
"nauticalmile",1,1,1,0,0,0,22,"EDI DataOne",2,1,1,23
"decimeter",4,10,17,0,0,0,5,"EDI DataOne",2,4,10,22
"centimetersperday",3,9,9,0,0,0,13,"EDI DataOne",2,3,9,22
"gramsperliter",7,9,16,0,0,0,6,"EDI DataOne",2,7,9,22
"cm3",3,6,6,0,0,0,16,"EDI DataOne",2,3,6,22
"picomoleperliterperhour",2,6,13,0,0,0,9,"EDI DataOne",2,2,6,22
"megagramperhectare",4,5,18,0,0,0,4,"EDI DataOne",2,4,5,22
"qsu",2,5,18,0,0,0,4,"EDI DataOne",2,2,5,22
"ampere",3,3,5,0,0,0,17,"EDI DataOne",2,3,3,22
"milligramperkilogram",1,2,21,0,0,0,1,"EDI DataOne",2,1,2,22
"wm-2",1,2,21,0,0,0,1,"EDI DataOne",2,1,2,22
"days",1,1,1,0,0,0,21,"EDI DataOne",2,1,1,22
"mm/year",1,1,1,0,0,0,21,"EDI DataOne",2,1,1,22
"degrees azimuth",1,11,20,0,0,0,1,"EDI DataOne",2,1,11,21
"lux",4,10,20,0,0,0,1,"EDI DataOne",2,4,10,21
"centimeterssquaredpergram",3,9,17,0,0,0,4,"EDI DataOne",2,3,9,21
"tonsperacre",4,8,9,0,0,0,12,"EDI DataOne",2,4,8,21
"deg-c",1,7,9,0,0,0,12,"EDI DataOne",2,1,7,21
"formazinnephelometricunits",2,7,19,0,0,0,2,"EDI DataOne",2,2,7,21
"thousands",1,6,6,0,0,0,15,"EDI DataOne",2,1,6,21
"nanomolepermetersquaredpersecond",2,4,19,0,0,0,2,"EDI DataOne",2,2,4,21
"micromoleperliterperday",3,3,9,0,0,0,12,"EDI DataOne",2,3,3,21
"centimolechargeperkilogram",1,2,14,0,0,0,7,"EDI DataOne",2,1,2,21
"nanomolesperkilogramperday",1,1,18,0,0,0,3,"EDI DataOne",2,1,1,21
"numberpersquaremeter",1,1,19,0,0,0,2,"EDI DataOne",2,1,1,21
"picomolesperliterperhour",1,13,13,0,0,0,7,"EDI DataOne",2,1,13,20
"mm",1,10,10,0,0,0,10,"EDI DataOne",2,1,10,20
"microgrampercentimetersquared",5,7,19,0,0,0,1,"EDI DataOne",2,5,7,20
"millimolepermetersquaredperhour",4,6,17,0,0,0,3,"EDI DataOne",2,4,6,20
"molepermetersquared",3,4,19,0,0,0,1,"EDI DataOne",2,3,4,20
"numberpersquarecentimeterperhour",1,4,16,0,0,0,4,"EDI DataOne",2,1,4,20
"numberperday",2,3,19,0,0,0,1,"EDI DataOne",2,2,3,20
"ue",1,3,13,0,0,0,7,"EDI DataOne",2,1,3,20
"micromoleperhourpergram",2,2,16,0,0,0,4,"EDI DataOne",2,2,2,20
"micrometers",1,1,10,0,0,0,10,"EDI DataOne",2,1,1,20
"microcuriepermicromole",1,12,12,0,0,0,7,"EDI DataOne",2,1,12,19
"microeinsteinpermetersquaredpersecond",4,10,16,0,0,0,3,"EDI DataOne",2,4,10,19
"yy",1,10,10,0,0,0,9,"EDI DataOne",2,1,10,19
"gramspercentimetercubed",4,9,9,0,0,0,10,"EDI DataOne",2,4,9,19
"m2/ha",2,7,17,0,0,0,2,"EDI DataOne",2,2,7,19
"milligrampercentimetersquared",4,7,15,0,0,0,4,"EDI DataOne",2,4,7,19
"micromolpersquaremeterpersecond",1,6,18,0,0,0,1,"EDI DataOne",2,1,6,19
"microgramspercentimetersquared",2,5,17,0,0,0,2,"EDI DataOne",2,2,5,19
"unknown",2,5,8,0,0,0,11,"EDI DataOne",2,2,5,19
"millibars",2,3,16,0,0,0,3,"EDI DataOne",2,2,3,19
"gallonperminute",1,1,4,0,0,0,15,"EDI DataOne",2,1,1,19
"maxberries(gbiomass)-1m-2",1,1,9,0,0,0,10,"EDI DataOne",2,1,1,19
"degrees angle",1,5,16,0,0,0,2,"EDI DataOne",2,1,5,18
"gramsperhectareperday",2,5,11,0,0,0,7,"EDI DataOne",2,2,5,18
"cubic meters",1,4,5,0,0,0,13,"EDI DataOne",2,1,4,18
"umol/m2/s",1,3,9,0,0,0,9,"EDI DataOne",2,1,3,18
"micromol/l",1,1,6,0,0,0,12,"EDI DataOne",2,1,1,18
"moleperhectare",1,1,9,0,0,0,9,"EDI DataOne",2,1,1,18
"nephelometricturbidityunit",2,10,15,0,0,0,2,"EDI DataOne",2,2,10,17
"calendar year",2,7,9,0,0,0,8,"EDI DataOne",2,2,7,17
"micromolesperkilogram",2,6,14,0,0,0,3,"EDI DataOne",2,2,6,17
"milligrampergramperday",3,5,16,0,0,0,1,"EDI DataOne",2,3,5,17
"milligrampermetercubedperhour",3,5,13,0,0,0,4,"EDI DataOne",2,3,5,17
"millimetersquared",4,5,12,0,0,0,5,"EDI DataOne",2,4,5,17
"number",1,3,10,0,0,0,7,"EDI DataOne",2,1,3,17
"umolm-2s-1",1,3,16,0,0,0,1,"EDI DataOne",2,1,3,17
"cubiccm",1,2,4,0,0,0,13,"EDI DataOne",2,1,2,17
"mgco2/d",1,2,11,0,0,0,6,"EDI DataOne",2,1,2,17
"ppm/d",1,2,11,0,0,0,6,"EDI DataOne",2,1,2,17
"gramperhectareperday",1,1,8,0,0,0,9,"EDI DataOne",2,1,1,17
"meter",1,1,15,0,0,0,2,"EDI DataOne",2,1,1,17
"replicate",1,8,8,0,0,0,8,"EDI DataOne",2,1,8,16
"cubiccentimeter",4,6,9,0,0,0,7,"EDI DataOne",2,4,6,16
"milligrampergramperhour",4,6,11,0,0,0,5,"EDI DataOne",2,4,6,16
"gramspermetersquaredperday",3,4,6,0,0,0,10,"EDI DataOne",2,3,4,16
"gcm-2yr-1",1,3,9,0,0,0,7,"EDI DataOne",2,1,3,16
"mg/g",2,3,7,0,0,0,9,"EDI DataOne",2,2,3,16
"microgramsperliterquininesulfateunits",1,3,14,0,0,0,2,"EDI DataOne",2,1,3,16
"hours",2,2,7,0,0,0,9,"EDI DataOne",2,2,2,16
"meq/100g",2,2,11,0,0,0,5,"EDI DataOne",2,2,2,16
"microgramsperliter",2,2,10,0,0,0,6,"EDI DataOne",2,2,2,16
"micromolespergram",2,2,15,0,0,0,1,"EDI DataOne",2,2,2,16
"squaremeterperkilogram",2,2,7,0,0,0,9,"EDI DataOne",2,2,2,16
"centimeterpersecondsquared",1,1,15,0,0,0,1,"EDI DataOne",2,1,1,16
"grampermetersquaredperdaypereffort",1,1,8,0,0,0,8,"EDI DataOne",2,1,1,16
"mg/kg",1,1,2,0,0,0,14,"EDI DataOne",2,1,1,16
"milliequivalentper100grams",1,1,5,0,0,0,11,"EDI DataOne",2,1,1,16
"mm/dd/yyyy",1,1,4,0,0,0,12,"EDI DataOne",2,1,1,16
"centimetersquaredpergram",7,11,13,0,0,0,2,"EDI DataOne",2,7,11,15
"nephelometric turbidity units",1,6,8,0,0,0,7,"EDI DataOne",2,1,6,15
"megajoulepermetersquaredperday",4,5,13,0,0,0,2,"EDI DataOne",2,4,5,15
"kilogramperliter",3,4,6,0,0,0,9,"EDI DataOne",2,3,4,15
"milligramsperliterperday",2,4,12,0,0,0,3,"EDI DataOne",2,2,4,15
"millimetermercury",2,4,6,0,0,0,9,"EDI DataOne",2,2,4,15
"centimeterspergram",3,3,11,0,0,0,4,"EDI DataOne",2,3,3,15
"km",2,2,7,0,0,0,8,"EDI DataOne",2,2,2,15
"microgrampermetersquaredperday",1,2,7,0,0,0,8,"EDI DataOne",2,1,2,15
"parts per thousand",2,2,2,0,0,0,13,"EDI DataOne",2,2,2,15
"# pairs",1,1,8,0,0,0,7,"EDI DataOne",2,1,1,15
"micromolsco2m-2s-1",1,1,6,0,0,0,9,"EDI DataOne",2,1,1,15
"ug/m3",1,1,14,0,0,0,1,"EDI DataOne",2,1,1,15
"percent g/g",1,10,10,0,0,0,4,"EDI DataOne",2,1,10,14
"ddd",1,9,10,0,0,0,4,"EDI DataOne",2,1,9,14
"gramspermetersquaredperhour",4,6,13,0,0,0,1,"EDI DataOne",2,4,6,14
"yyyy",4,6,7,0,0,0,7,"EDI DataOne",2,4,6,14
"dd",1,5,5,0,0,0,9,"EDI DataOne",2,1,5,14
"microseimenpercentimeter",1,5,13,0,0,0,1,"EDI DataOne",2,1,5,14
"ppt",4,5,8,0,0,0,6,"EDI DataOne",2,4,5,14
"milligramspergrams",1,3,12,0,0,0,2,"EDI DataOne",2,1,3,14
"microgramspermetersquaredperhour",1,2,5,0,0,0,9,"EDI DataOne",2,1,2,14
"#/m2",1,1,7,0,0,0,7,"EDI DataOne",2,1,1,14
"?",1,1,11,0,0,0,3,"EDI DataOne",2,1,1,14
"kilogramperkilometersquaredperyear",1,1,7,0,0,0,7,"EDI DataOne",2,1,1,14
"milligramsperliter",1,1,7,0,0,0,7,"EDI DataOne",2,1,1,14
"millimeterpermonth",1,1,1,0,0,0,13,"EDI DataOne",2,1,1,14
"millimole",1,1,6,0,0,0,8,"EDI DataOne",2,1,1,14
"nmolpergramperhour",1,1,7,0,0,0,7,"EDI DataOne",2,1,1,14
"nmolperhourpermicrogram",1,1,7,0,0,0,7,"EDI DataOne",2,1,1,14
"oc",1,1,2,0,0,0,12,"EDI DataOne",2,1,1,14
"per mil",1,1,3,0,0,0,11,"EDI DataOne",2,1,1,14
"standard units",1,1,1,0,0,0,13,"EDI DataOne",2,1,1,14
"standardcubicfootperhour",1,1,7,0,0,0,7,"EDI DataOne",2,1,1,14
"trees/ha",1,8,8,0,0,0,5,"EDI DataOne",2,1,8,13
"atmosphere",5,6,6,0,0,0,7,"EDI DataOne",2,5,6,13
"grampergramperday",5,5,11,0,0,0,2,"EDI DataOne",2,5,5,13
"milligramspersquaremeterperday",3,5,7,0,0,0,6,"EDI DataOne",2,3,5,13
"gco2-cm-2half-hour-2",1,4,8,0,0,0,5,"EDI DataOne",2,1,4,13
"gco2-cm-2half-hour-3",1,4,8,0,0,0,5,"EDI DataOne",2,1,4,13
"millimetercubedperliter",2,3,11,0,0,0,2,"EDI DataOne",2,2,3,13
"millimetersperday",1,3,11,0,0,0,2,"EDI DataOne",2,1,3,13
"permill",2,2,11,1,1,2,0,"EDI NEON",2,3,3,13
"cells/ml",2,2,5,0,0,0,8,"EDI DataOne",2,2,2,13
"gcm-2",1,2,7,0,0,0,6,"EDI DataOne",2,1,2,13
"kilogramspermetersquaredperyear",2,2,5,0,0,0,8,"EDI DataOne",2,2,2,13
"metercubedpermetersquared",1,2,6,0,0,0,7,"EDI DataOne",2,1,2,13
"cmweq",1,1,7,0,0,0,6,"EDI DataOne",2,1,1,13
"hundrethofdegreecelsius",1,1,12,0,0,0,1,"EDI DataOne",2,1,1,13
"milligrampermetersquaredpersecond",1,1,6,0,0,0,7,"EDI DataOne",2,1,1,13
"molesperkilogram",1,1,5,0,0,0,8,"EDI DataOne",2,1,1,13
"g/m3",2,6,6,0,0,0,6,"EDI DataOne",2,2,6,12
"doy",2,5,5,0,0,0,7,"EDI DataOne",2,2,5,12
"milligramspermetersquaredperday",2,5,11,0,0,0,1,"EDI DataOne",2,2,5,12
"kilojoulepermetersquared",2,4,9,0,0,0,3,"EDI DataOne",2,2,4,12
"micromolepermicromole",1,4,8,0,0,0,4,"EDI DataOne",2,1,4,12
"milligramperunit",1,4,10,0,0,0,2,"EDI DataOne",2,1,4,12
"molespermetersquared",2,4,6,0,0,0,6,"EDI DataOne",2,2,4,12
"nanomoleperliter",3,4,6,0,0,0,6,"EDI DataOne",2,3,4,12
"gramspermilliliter",2,3,4,0,0,0,8,"EDI DataOne",2,2,3,12
"ug/l",2,3,5,0,0,0,7,"EDI DataOne",2,2,3,12
"utm",2,3,6,0,0,0,6,"EDI DataOne",2,2,3,12
"becquerelpergram",2,2,11,0,0,0,1,"EDI DataOne",2,2,2,12
"meterssquaredpersecond",2,2,2,0,0,0,10,"EDI DataOne",2,2,2,12
"microeinstein",2,2,10,0,0,0,2,"EDI DataOne",2,2,2,12
"microg/cm2",1,2,10,0,0,0,2,"EDI DataOne",2,1,2,12
"miligramsperkilogrampermonth",1,2,5,0,0,0,7,"EDI DataOne",2,1,2,12
"britishthermalunit",1,1,4,0,0,0,8,"EDI DataOne",2,1,1,12
"gramsperhectareperhour",1,1,6,0,0,0,6,"EDI DataOne",2,1,1,12
"mg/gdryleaftissue",1,1,4,0,0,0,8,"EDI DataOne",2,1,1,12
"percentbymass",1,1,6,0,0,0,6,"EDI DataOne",2,1,1,12
"ramanunit",1,1,4,0,0,0,8,"EDI DataOne",2,1,1,12
"ug",1,1,6,0,0,0,6,"EDI DataOne",2,1,1,12
"langley",2,6,8,0,0,0,3,"EDI DataOne",2,2,6,11
"grams per cubic centimeter",1,5,8,0,0,0,3,"EDI DataOne",2,1,5,11
"hhmm",1,5,5,0,0,0,6,"EDI DataOne",2,1,5,11
"metersabovesealevel",2,5,9,0,0,0,2,"EDI DataOne",2,2,5,11
"microgramspersquarecentimeter",3,5,6,0,0,0,5,"EDI DataOne",2,3,5,11
"gramspersquarecentimeter",3,4,9,0,0,0,2,"EDI DataOne",2,3,4,11
"months",3,4,4,0,0,0,7,"EDI DataOne",2,3,4,11
"gramspersample",1,3,3,0,0,0,8,"EDI DataOne",2,1,3,11
"micromoles per second per square meter",2,3,6,0,0,0,5,"EDI DataOne",2,2,3,11
"millimolespermole",1,3,5,0,0,0,6,"EDI DataOne",2,1,3,11
"gramspergram",1,2,4,0,0,0,7,"EDI DataOne",2,1,2,11
"microgramsperkilogramperhour",2,2,5,0,0,0,6,"EDI DataOne",2,2,2,11
"month of year",1,2,2,0,0,0,9,"EDI DataOne",2,1,2,11
"umol/mol",1,2,10,0,0,0,1,"EDI DataOne",2,1,2,11
"umolesco2/(m^2*s",1,2,8,0,0,0,3,"EDI DataOne",2,1,2,11
"atompercent",1,1,10,0,0,0,1,"EDI DataOne",2,1,1,11
"milligramperdecimetersquared",1,1,5,0,0,0,6,"EDI DataOne",2,1,1,11
"numberpernauticalmilesquared",1,1,2,0,0,0,9,"EDI DataOne",2,1,1,11
"tritiumunit",1,1,2,0,0,0,9,"EDI DataOne",2,1,1,11
"gramspercubicmeter",1,7,7,0,0,0,3,"EDI DataOne",2,1,7,10
"metersperday",3,7,8,0,0,0,2,"EDI DataOne",2,3,7,10
"nephelometric turbidity unit",3,7,8,0,0,0,2,"EDI DataOne",2,3,7,10
"year(yyyy)",1,6,6,0,0,0,4,"EDI DataOne",2,1,6,10
"micrometercubed",4,5,7,0,0,0,3,"EDI DataOne",2,4,5,10
"microsiemens per centimeter",2,5,8,0,0,0,2,"EDI DataOne",2,2,5,10
"milligramspersquarecentimeter",2,5,6,0,0,0,4,"EDI DataOne",2,2,5,10
"nanomolepergrampersecond",2,3,5,0,0,0,5,"EDI DataOne",2,2,3,10
"umolphotons/m2/second",2,3,6,0,0,0,4,"EDI DataOne",2,2,3,10
"day of month",1,2,2,0,0,0,8,"EDI DataOne",2,1,2,10
"grampernumber",1,2,5,0,0,0,5,"EDI DataOne",2,1,2,10
"kilogramspercubicmeter",2,2,9,0,0,0,1,"EDI DataOne",2,2,2,10
"milliequivalents",1,2,2,0,0,0,8,"EDI DataOne",2,1,2,10
"molepercubicmeter",1,2,4,0,0,0,6,"EDI DataOne",2,1,2,10
"%peryear",1,1,5,0,0,0,5,"EDI DataOne",2,1,1,10
"cperyear",1,1,5,0,0,0,5,"EDI DataOne",2,1,1,10
"cubicmicrometerspercentimeterssquared",1,1,9,0,0,0,1,"EDI DataOne",2,1,1,10
"date",1,1,1,0,0,0,9,"EDI DataOne",2,1,1,10
"mg/m3",1,1,2,0,0,0,8,"EDI DataOne",2,1,1,10
"microgramperliter",1,1,3,0,0,0,7,"EDI DataOne",2,1,1,10
"miligramsperkilogramperday",1,1,3,0,0,0,7,"EDI DataOne",2,1,1,10
"milligramspermetersquaredperhour",1,1,3,0,0,0,7,"EDI DataOne",2,1,1,10
"mmperyear",1,1,5,0,0,0,5,"EDI DataOne",2,1,1,10
"numberper10centimetersquared",1,1,9,0,0,0,1,"EDI DataOne",2,1,1,10
"seconds",1,1,1,0,0,0,9,"EDI DataOne",2,1,1,10
"microsiemens/cm",1,7,7,0,0,0,2,"EDI DataOne",2,1,7,9
"formazinnephelometricunit",1,5,5,1,1,4,0,"EDI NEON",2,2,6,9
"month",4,5,7,0,0,0,2,"EDI DataOne",2,4,5,9
"micromoles per square meter per second",2,4,8,0,0,0,1,"EDI DataOne",2,2,4,9
"milligramsperday",4,4,6,0,0,0,3,"EDI DataOne",2,4,4,9
"moleperliter",3,4,6,0,0,0,3,"EDI DataOne",2,3,4,9
"numberpernumber",3,4,4,0,0,0,5,"EDI DataOne",2,3,4,9
"cord",1,3,5,0,0,0,4,"EDI DataOne",2,1,3,9
"footcubed",1,3,4,0,0,0,5,"EDI DataOne",2,1,3,9
"gramspermeterssquared",1,3,5,0,0,0,4,"EDI DataOne",2,1,3,9
"wattspermetersquared",3,3,7,0,0,0,2,"EDI DataOne",2,3,3,9
"cubicmetersperhour",1,1,8,1,1,1,0,"EDI NEON",2,2,2,9
"decaysperminuteperliter",1,2,8,0,0,0,1,"EDI DataOne",2,1,2,9
"degrees c",1,2,2,0,0,0,7,"EDI DataOne",2,1,2,9
"g/cc",2,2,4,0,0,0,5,"EDI DataOne",2,2,2,9
"millisiemens",2,2,5,0,0,0,4,"EDI DataOne",2,2,2,9
"% afdw",1,1,4,0,0,0,5,"EDI DataOne",2,1,1,9
"% dry mass",1,1,8,0,0,0,1,"EDI DataOne",2,1,1,9
"10^3 copies/g",1,1,8,0,0,0,1,"EDI DataOne",2,1,1,9
"cells per milliliter",1,1,1,0,0,0,8,"EDI DataOne",2,1,1,9
"disintegrationsperminutepercubicmeter",1,1,8,0,0,0,1,"EDI DataOne",2,1,1,9
"grampermilliliter",1,1,8,0,0,0,1,"EDI DataOne",2,1,1,9
"kilogramsperhectarepermonth",1,1,3,0,0,0,6,"EDI DataOne",2,1,1,9
"milligramsoxygenper literperday",1,1,3,0,0,0,6,"EDI DataOne",2,1,1,9
"mmhg",1,1,5,0,0,0,4,"EDI DataOne",2,1,1,9
"nanogramspercubicmeter",1,1,3,0,0,0,6,"EDI DataOne",2,1,1,9
"ugn/gdrysoil",1,1,3,0,0,0,6,"EDI DataOne",2,1,1,9
"umol/m2/yr",1,1,8,0,0,0,1,"EDI DataOne",2,1,1,9
"milliliters",2,5,7,0,0,0,1,"EDI DataOne",2,2,5,8
"molespersquaremeterpersecond",3,5,6,0,0,0,2,"EDI DataOne",2,3,5,8
"cubic centimeters",2,3,6,0,0,0,2,"EDI DataOne",2,2,3,8
"microsiemenspercentimeters",1,3,4,0,0,0,4,"EDI DataOne",2,1,3,8
"millgramspergram",2,3,6,0,0,0,2,"EDI DataOne",2,2,3,8
"millimolespersquaremeterperhour",2,3,6,0,0,0,2,"EDI DataOne",2,2,3,8
"nanogrampergram",2,3,4,0,0,0,4,"EDI DataOne",2,2,3,8
"centimeterpercentimetercubed",2,2,6,0,0,0,2,"EDI DataOne",2,2,2,8
"cm.",1,2,6,0,0,0,2,"EDI DataOne",2,1,2,8
"cubicmicrometerspergram",2,2,3,0,0,0,5,"EDI DataOne",2,2,2,8
"degrees c",1,2,3,0,0,0,5,"EDI DataOne",2,1,2,8
"micromolepersecond",2,2,3,0,0,0,5,"EDI DataOne",2,2,2,8
"milligrams",2,2,5,0,0,0,3,"EDI DataOne",2,2,2,8
"milliliterspergram",1,2,4,0,0,0,4,"EDI DataOne",2,1,2,8
"nanogramspergramperday",2,2,4,0,0,0,4,"EDI DataOne",2,2,2,8
"no.ofstems/m2",1,2,4,0,0,0,4,"EDI DataOne",2,1,2,8
"ppt",1,2,3,0,0,0,5,"EDI DataOne",2,1,2,8
"%volumetricwatercontent",1,1,4,0,0,0,4,"EDI DataOne",2,1,1,8
"?gn/groot/hour",1,1,4,0,0,0,4,"EDI DataOne",2,1,1,8
"degreedays",1,1,6,0,0,0,2,"EDI DataOne",2,1,1,8
"formazin nephelometric unit (fnu)",1,1,3,0,0,0,5,"EDI DataOne",2,1,1,8
"gkg-1",1,1,4,0,0,0,4,"EDI DataOne",2,1,1,8
"id",1,1,6,0,0,0,2,"EDI DataOne",2,1,1,8
"microm/s/m2",1,1,4,0,0,0,4,"EDI DataOne",2,1,1,8
"milligramperdaypergram",1,1,4,0,0,0,4,"EDI DataOne",2,1,1,8
"milligrampermetersquaredperhalfday",1,1,4,0,0,0,4,"EDI DataOne",2,1,1,8
"mm/dd/yyyy",1,1,1,0,0,0,7,"EDI DataOne",2,1,1,8
"numberper85centimetersquaredperday",1,1,7,0,0,0,1,"EDI DataOne",2,1,1,8
"percentpermetersquared",1,1,4,0,0,0,4,"EDI DataOne",2,1,1,8
"microg/gsoil",1,5,5,0,0,0,2,"EDI DataOne",2,1,5,7
"meterpergram",4,4,4,0,0,0,3,"EDI DataOne",2,4,4,7
"mg/cm2",2,4,4,0,0,0,3,"EDI DataOne",2,2,4,7
"milliequivalentsperliter",1,2,3,1,2,4,0,"EDI NEON",2,2,4,7
"squaremile",3,4,4,0,0,0,3,"EDI DataOne",2,3,4,7
"cubiccentimeters",1,2,6,0,0,0,1,"EDI DataOne",2,1,2,7
"grams/cubiccm",1,2,4,0,0,0,3,"EDI DataOne",2,1,2,7
"micromolespergramperhour",2,2,5,0,0,0,2,"EDI DataOne",2,2,2,7
"millibar",1,2,6,0,0,0,1,"EDI DataOne",2,1,2,7
"milligramspershortshoot",1,2,3,0,0,0,4,"EDI DataOne",2,1,2,7
"molespermetersquaredpersecond",2,2,3,0,0,0,4,"EDI DataOne",2,2,2,7
"numberbasepairs",1,2,5,0,0,0,2,"EDI DataOne",2,1,2,7
"counts",1,1,1,0,0,0,6,"EDI DataOne",2,1,1,7
"cubicmeterspercubicmeter",1,1,3,0,0,0,4,"EDI DataOne",2,1,1,7
"ft",1,1,1,0,0,0,6,"EDI DataOne",2,1,1,7
"g.",1,1,6,0,0,0,1,"EDI DataOne",2,1,1,7
"gramsoxygenpermetersquaredperday",1,1,2,0,0,0,5,"EDI DataOne",2,1,1,7
"microgramnitrogenpermetersquaredpersecond",1,1,2,0,0,0,5,"EDI DataOne",2,1,1,7
"milligramperliter",1,1,2,0,0,0,5,"EDI DataOne",2,1,1,7
"milligramsperkilogramperday",1,1,6,0,0,0,1,"EDI DataOne",2,1,1,7
"nanomolespermetersquaredperday",1,1,4,0,0,0,3,"EDI DataOne",2,1,1,7
"wattsperm-2",1,1,4,0,0,0,3,"EDI DataOne",2,1,1,7
"grampermetersquaredperhour",3,4,5,0,0,0,1,"EDI DataOne",2,3,4,6
"micrometercubedpermilliliter",3,4,4,0,0,0,2,"EDI DataOne",2,3,4,6
"micromolespermolesquaredpersecond",1,4,4,0,0,0,2,"EDI DataOne",2,1,4,6
"squarecentimeterspergram",3,4,4,0,0,0,2,"EDI DataOne",2,3,4,6
"grams per square meter",2,3,4,0,0,0,2,"EDI DataOne",2,2,3,6
"millilitersperminute",0,0,0,1,3,5,1,"NEON DataOne",2,1,3,6
"mm",1,3,3,0,0,0,3,"EDI DataOne",2,1,3,6
"umolco2m-2s-1",1,3,5,0,0,0,1,"EDI DataOne",2,1,3,6
"grampersqauremeter",1,2,2,0,0,0,4,"EDI DataOne",2,1,2,6
"m/sec",1,2,3,0,0,0,3,"EDI DataOne",2,1,2,6
"mgch4/m2/d",1,2,4,0,0,0,2,"EDI DataOne",2,1,2,6
"micromolespermetersquaredpersecond",1,2,5,0,0,0,1,"EDI DataOne",2,1,2,6
"seeds",1,2,3,0,0,0,3,"EDI DataOne",2,1,2,6
"umol/kg",1,2,4,0,0,0,2,"EDI DataOne",2,1,2,6
"wattspersquaremeter",2,2,2,0,0,0,4,"EDI DataOne",2,2,2,6
"#/m^2",1,1,3,0,0,0,3,"EDI DataOne",2,1,1,6
"beaufort",1,1,2,0,0,0,4,"EDI DataOne",2,1,1,6
"decaysperminute",1,1,3,0,0,0,3,"EDI DataOne",2,1,1,6
"decaysperminutepermetersquaredperday",1,1,2,0,0,0,4,"EDI DataOne",2,1,1,6
"g/tree",1,1,2,0,0,0,4,"EDI DataOne",2,1,1,6
"hectorpascal",1,1,2,0,0,0,4,"EDI DataOne",2,1,1,6
"metersquaredpernauticalmilesquared",1,1,1,0,0,0,5,"EDI DataOne",2,1,1,6
"mg/gsoil",1,1,5,0,0,0,1,"EDI DataOne",2,1,1,6
"miligramspergramsoilperday",1,1,3,0,0,0,3,"EDI DataOne",2,1,1,6
"millilitersperdayperconcentration",1,1,3,0,0,0,3,"EDI DataOne",2,1,1,6
"minute",1,1,1,0,0,0,5,"EDI DataOne",2,1,1,6
"minutes",1,1,3,0,0,0,3,"EDI DataOne",2,1,1,6
"partspertrillion",1,1,2,0,0,0,4,"EDI DataOne",2,1,1,6
"picomolepermetersquaredpersecond",1,1,3,0,0,0,3,"EDI DataOne",2,1,1,6
"second",1,1,1,0,0,0,5,"EDI DataOne",2,1,1,6
"ugn/gdrysoil/day",1,1,2,0,0,0,4,"EDI DataOne",2,1,1,6
"umoles/lit",1,1,5,0,0,0,1,"EDI DataOne",2,1,1,6
"metercubedpergram",1,4,4,0,0,0,1,"EDI DataOne",2,1,4,5
"nanogrampercentimetersquaredperhour",2,4,4,0,0,0,1,"EDI DataOne",2,2,4,5
"umolco2m-2sec-1",1,4,4,0,0,0,1,"EDI DataOne",2,1,4,5
"gramsperyear",3,3,3,0,0,0,2,"EDI DataOne",2,3,3,5
"microgramsperliterperday",2,3,3,0,0,0,2,"EDI DataOne",2,2,3,5
"partperbillion",2,3,3,0,0,0,2,"EDI DataOne",2,2,3,5
"at/ul",1,2,3,0,0,0,2,"EDI DataOne",2,1,2,5
"centimeterssquaredpergram",1,2,2,0,0,0,3,"EDI DataOne",2,1,2,5
"gbiomassm-2",1,2,2,0,0,0,3,"EDI DataOne",2,1,2,5
"kilojoulepermetersquaredperday",1,2,3,0,0,0,2,"EDI DataOne",2,1,2,5
"literspersquaremeter",2,2,4,0,0,0,1,"EDI DataOne",2,2,2,5
"megajoulepermetersquaredperyear",1,2,4,0,0,0,1,"EDI DataOne",2,1,2,5
"micromolesperliterperhour",2,2,4,0,0,0,1,"EDI DataOne",2,2,2,5
"mileperhour",2,2,2,0,0,0,3,"EDI DataOne",2,2,2,5
"miligramsperkiligram",1,2,3,0,0,0,2,"EDI DataOne",2,1,2,5
"milligrampercentimetercubed",1,2,4,0,0,0,1,"EDI DataOne",2,1,2,5
"milligrampergramperhourperphotonflux",1,2,3,0,0,0,2,"EDI DataOne",2,1,2,5
"ms/cm",1,2,3,0,0,0,2,"EDI DataOne",2,1,2,5
"picocuriespergram",2,2,3,0,0,0,2,"EDI DataOne",2,2,2,5
"vwc%",1,2,3,0,0,0,2,"EDI DataOne",2,1,2,5
"cellpermetersquaredperday",1,1,4,0,0,0,1,"EDI DataOne",2,1,1,5
"degreescelsius",1,1,2,0,0,0,3,"EDI DataOne",2,1,1,5
"g/cm3",1,1,2,0,0,0,3,"EDI DataOne",2,1,1,5
"hours",1,1,3,0,0,0,2,"EDI DataOne",2,1,1,5
"joulespersquaremeter",1,1,1,0,0,0,4,"EDI DataOne",2,1,1,5
"kg.",1,1,1,0,0,0,4,"EDI DataOne",2,1,1,5
"lumenpermetersquare",1,1,4,0,0,0,1,"EDI DataOne",2,1,1,5
"mg/m2/sec",1,1,2,0,0,0,3,"EDI DataOne",2,1,1,5
"microgramspercubiccentimeter",1,1,3,0,0,0,2,"EDI DataOne",2,1,1,5
"micromolespersecond",1,1,2,0,0,0,3,"EDI DataOne",2,1,1,5
"micromolsradiationm-2s-1",1,1,2,0,0,0,3,"EDI DataOne",2,1,1,5
"miligramsperliter",1,1,2,0,0,0,3,"EDI DataOne",2,1,1,5
"millilitersperkilogramsperday",1,1,2,0,0,0,3,"EDI DataOne",2,1,1,5
"millilitersperkilogramsperdayperconcentration",1,1,2,0,0,0,3,"EDI DataOne",2,1,1,5
"millimeterperhalfhour",1,1,2,0,0,0,3,"EDI DataOne",2,1,1,5
"mmho/cm",1,1,2,0,0,0,3,"EDI DataOne",2,1,1,5
"months",1,1,3,0,0,0,2,"EDI DataOne",2,1,1,5
"nanogramspercubiccentimeterperday",1,1,3,0,0,0,2,"EDI DataOne",2,1,1,5
"ndvi",1,1,4,0,0,0,1,"EDI DataOne",2,1,1,5
"per mill",1,1,4,0,0,0,1,"EDI DataOne",2,1,1,5
"percent saturation",1,1,1,0,0,0,4,"EDI DataOne",2,1,1,5
"ppmperday",1,1,2,0,0,0,3,"EDI DataOne",2,1,1,5
"square meter",1,1,1,0,0,0,4,"EDI DataOne",2,1,1,5
"turbidity units",1,1,2,0,0,0,3,"EDI DataOne",2,1,1,5
"umol/g",1,1,2,0,0,0,3,"EDI DataOne",2,1,1,5
"umol/l",1,1,4,0,0,0,1,"EDI DataOne",2,1,1,5
"ds/m",1,3,3,0,0,0,1,"EDI DataOne",2,1,3,4
"gcm-3",1,3,3,0,0,0,1,"EDI DataOne",2,1,3,4
"kilogrampermole",1,3,3,0,0,0,1,"EDI DataOne",2,1,3,4
"micromolespersecond",1,3,3,0,0,0,1,"EDI DataOne",2,1,3,4
"mm/dd/yy",1,3,3,0,0,0,1,"EDI DataOne",2,1,3,4
"molepersquaremeterpersecond",1,3,3,0,0,0,1,"EDI DataOne",2,1,3,4
"ug/g",1,3,3,0,0,0,1,"EDI DataOne",2,1,3,4
"#/kg dry soil",1,2,2,0,0,0,2,"EDI DataOne",2,1,2,4
"bytes",1,2,2,0,0,0,2,"EDI DataOne",2,1,2,4
"degrees-c",1,2,2,0,0,0,2,"EDI DataOne",2,1,2,4
"degreeslatitudeorlongitude",1,2,3,0,0,0,1,"EDI DataOne",2,1,2,4
"g/0.25m2",1,2,2,0,0,0,2,"EDI DataOne",2,1,2,4
"gramper_pt25metersquared",1,2,3,0,0,0,1,"EDI DataOne",2,1,2,4
"gramsh2oper100gramsdrysoil",1,2,2,0,0,0,2,"EDI DataOne",2,1,2,4
"gramspercentimetersquaredpersecond",1,2,2,0,0,0,2,"EDI DataOne",2,1,2,4
"hh",1,2,2,0,0,0,2,"EDI DataOne",2,1,2,4
"inchperyear",1,2,3,0,0,0,1,"EDI DataOne",2,1,2,4
"kilopascal",2,2,3,0,0,0,1,"EDI DataOne",2,2,2,4
"metercubedperyear",2,2,3,0,0,0,1,"EDI DataOne",2,2,2,4
"metersquaredpernumber",1,2,2,0,0,0,2,"EDI DataOne",2,1,2,4
"mg/cm2/hr",1,2,2,0,0,0,2,"EDI DataOne",2,1,2,4
"mgc/gafdm/hr",1,2,2,0,0,0,2,"EDI DataOne",2,1,2,4
"mgc/gdrysoil",1,2,3,0,0,0,1,"EDI DataOne",2,1,2,4
"mgc/gsoilc",1,2,3,0,0,0,1,"EDI DataOne",2,1,2,4
"mgc/mgchla/hr",1,2,2,0,0,0,2,"EDI DataOne",2,1,2,4
"micomolespersquaremeterpersecond",1,2,2,0,0,0,2,"EDI DataOne",2,1,2,4
"milliequivalentsperhundredgram",1,2,2,0,0,0,2,"EDI DataOne",2,1,2,4
"milligramsperhectare",2,2,3,0,0,0,1,"EDI DataOne",2,2,2,4
"millimetercubed",2,2,2,0,0,0,2,"EDI DataOne",2,2,2,4
"mv",1,2,2,0,0,0,2,"EDI DataOne",2,1,2,4
"nounits",1,2,2,0,0,0,2,"EDI DataOne",2,1,2,4
"percentimeter",2,2,3,0,0,0,1,"EDI DataOne",2,2,2,4
"percentperday",2,2,3,0,0,0,1,"EDI DataOne",2,2,2,4
"pernanometer",1,2,3,0,0,0,1,"EDI DataOne",2,1,2,4
"platinumcobaltunits",1,2,3,0,0,0,1,"EDI DataOne",2,1,2,4
"sla",1,2,2,0,0,0,2,"EDI DataOne",2,1,2,4
"squarecentimeterspersquaremeterperday",1,2,2,0,0,0,2,"EDI DataOne",2,1,2,4
"wavenumber",2,2,2,0,0,0,2,"EDI DataOne",2,2,2,4
"caloriepergram",1,1,3,0,0,0,1,"EDI DataOne",2,1,1,4
"candela",1,1,2,0,0,0,2,"EDI DataOne",2,1,1,4
"centimetersquaredperyear",1,1,2,0,0,0,2,"EDI DataOne",2,1,1,4
"cubicinch",1,1,2,0,0,0,2,"EDI DataOne",2,1,1,4
"cubickilometer",1,1,1,0,0,0,3,"EDI DataOne",2,1,1,4
"decimeldegrees",1,1,2,0,0,0,2,"EDI DataOne",2,1,1,4
"degreeday15",1,1,1,0,0,0,3,"EDI DataOne",2,1,1,4
"degreesc",1,1,2,0,0,0,2,"EDI DataOne",2,1,1,4
"deld",1,1,2,0,0,0,2,"EDI DataOne",2,1,1,4
"deltapermil",1,1,2,0,0,0,2,"EDI DataOne",2,1,1,4
"dimesionless",1,1,2,0,0,0,2,"EDI DataOne",2,1,1,4
"dimessionless",1,1,2,0,0,0,2,"EDI DataOne",2,1,1,4
"enzymeactivitypergram",1,1,2,0,0,0,2,"EDI DataOne",2,1,1,4
"g/core",1,1,2,0,0,0,2,"EDI DataOne",2,1,1,4
"gramspermetersquaredpermonth",1,1,3,0,0,0,1,"EDI DataOne",2,1,1,4
"hour",1,1,1,0,0,0,3,"EDI DataOne",2,1,1,4
"inchofmercury",1,1,3,0,0,0,1,"EDI DataOne",2,1,1,4
"k",1,1,2,0,0,0,2,"EDI DataOne",2,1,1,4
"kgbiomass/ha/year",1,1,2,0,0,0,2,"EDI DataOne",2,1,1,4
"kilogramperhour",1,1,2,0,0,0,2,"EDI DataOne",2,1,1,4
"l/mgc/m",1,1,2,0,0,0,2,"EDI DataOne",2,1,1,4
"literspersecond",1,1,1,0,0,0,3,"EDI DataOne",2,1,1,4
"m/day",1,1,1,0,0,0,3,"EDI DataOne",2,1,1,4
"mbars",1,1,2,0,0,0,2,"EDI DataOne",2,1,1,4
"meters/year",1,1,2,0,0,0,2,"EDI DataOne",2,1,1,4
"meterspermeter",1,1,1,0,0,0,3,"EDI DataOne",2,1,1,4
"metersperminute",1,1,1,0,0,0,3,"EDI DataOne",2,1,1,4
"mgc/m2/h",1,1,2,0,0,0,2,"EDI DataOne",2,1,1,4
"microgramspersquaremeter per seconds",1,1,2,0,0,0,2,"EDI DataOne",2,1,1,4
"micromolepermetersquaredpersecondperpascal",1,1,2,0,0,0,2,"EDI DataOne",2,1,1,4
"micromolsperliterperhour",1,1,2,0,0,0,2,"EDI DataOne",2,1,1,4
"microseimens per centimeter",1,1,2,0,0,0,2,"EDI DataOne",2,1,1,4
"milesquared",1,1,1,0,0,0,3,"EDI DataOne",2,1,1,4
"milligrampergrampermonth",1,1,2,0,0,0,2,"EDI DataOne",2,1,1,4
"milligramscarbonperliter",1,1,2,0,0,0,2,"EDI DataOne",2,1,1,4
"milligramspercubicmeterperhour",1,1,2,0,0,0,2,"EDI DataOne",2,1,1,4
"milligramspermetersquared",1,1,3,0,0,0,1,"EDI DataOne",2,1,1,4
"milligramspermilliliter",1,1,2,0,0,0,2,"EDI DataOne",2,1,1,4
"millilitersperday",1,1,1,0,0,0,3,"EDI DataOne",2,1,1,4
"millimeterperunit",1,1,2,0,0,0,2,"EDI DataOne",2,1,1,4
"millimetersperhalfhour",1,1,2,0,0,0,2,"EDI DataOne",2,1,1,4
"millimolespermegapascalpermetersqured",1,1,2,0,0,0,2,"EDI DataOne",2,1,1,4
"ml",1,1,1,0,0,0,3,"EDI DataOne",2,1,1,4
"molepermetersquaredpersec",1,1,2,0,0,0,2,"EDI DataOne",2,1,1,4
"molequantapermetersquaredperday",1,1,1,0,0,0,3,"EDI DataOne",2,1,1,4
"molespersuaremeters",1,1,1,0,0,0,3,"EDI DataOne",2,1,1,4
"nmtdr/day",1,1,2,0,0,0,2,"EDI DataOne",2,1,1,4
"no3-n/gsoiln",1,1,3,0,0,0,1,"EDI DataOne",2,1,1,4
"number/milliliter",1,1,2,0,0,0,2,"EDI DataOne",2,1,1,4
"ppm/sec",1,1,2,0,0,0,2,"EDI DataOne",2,1,1,4
"thousandboardfoot",1,1,2,0,0,0,2,"EDI DataOne",2,1,1,4
"ugnh4-n/gsoiln",1,1,3,0,0,0,1,"EDI DataOne",2,1,1,4
"ugno3-n/gsoil",1,1,3,0,0,0,1,"EDI DataOne",2,1,1,4
"ugnutrient/gramresin",1,1,3,0,0,0,1,"EDI DataOne",2,1,1,4
"volts",1,1,1,0,0,0,3,"EDI DataOne",2,1,1,4
"% of init.",1,2,2,0,0,0,1,"EDI DataOne",2,1,2,3
"cm2",2,2,2,0,0,0,1,"EDI DataOne",2,2,2,3
"compassdegrees",1,2,2,0,0,0,1,"EDI DataOne",2,1,2,3
"cubicmetersperday",1,2,2,0,0,0,1,"EDI DataOne",2,1,2,3
"decimalhour",1,2,2,0,0,0,1,"EDI DataOne",2,1,2,3
"fish",1,2,2,0,0,0,1,"EDI DataOne",2,1,2,3
"fnu",2,2,2,0,0,0,1,"EDI DataOne",2,2,2,3
"gc(m^-2*30min^-1",1,2,2,0,0,0,1,"EDI DataOne",2,1,2,3
"hour_and_minute",1,2,2,0,0,0,1,"EDI DataOne",2,1,2,3
"literspermilligrampermeter",1,2,2,0,0,0,1,"EDI DataOne",2,1,2,3
"lmgc-1m-1",1,2,2,0,0,0,1,"EDI DataOne",2,1,2,3
"meterspergram",2,2,2,0,0,0,1,"EDI DataOne",2,2,2,3
"mgha-1",1,2,2,0,0,0,1,"EDI DataOne",2,1,2,3
"microliter",2,2,2,0,0,0,1,"EDI DataOne",2,2,2,3
"microseimen",1,2,2,0,0,0,1,"EDI DataOne",2,1,2,3
"milligramspercubicmeterperday",1,2,2,0,0,0,1,"EDI DataOne",2,1,2,3
"ounceperacre",1,2,2,0,0,0,1,"EDI DataOne",2,1,2,3
"ug chl-a/g",1,2,2,0,0,0,1,"EDI DataOne",2,1,2,3
"1",1,1,1,0,0,0,2,"EDI DataOne",2,1,1,3
"10^9 copies/g",1,1,2,0,0,0,1,"EDI DataOne",2,1,1,3
"age",1,1,1,0,0,0,2,"EDI DataOne",2,1,1,3
"b-1,4-glucosidase activity in nmoles of substrate converted per hour per gram sample dry weight",1,1,1,0,0,0,2,"EDI DataOne",2,1,1,3
"calendarday",1,1,1,0,0,0,2,"EDI DataOne",2,1,1,3
"cellobiohydrolase activity in nmoles of substrate converted per hour per gram sample dry weight",1,1,1,0,0,0,2,"EDI DataOne",2,1,1,3
"cells/ml",1,1,2,0,0,0,1,"EDI DataOne",2,1,1,3
"centimeterperminute",1,1,2,0,0,0,1,"EDI DataOne",2,1,1,3
"centimetersquaredpergram",1,1,2,0,0,0,1,"EDI DataOne",2,1,1,3
"cm^2pergram",1,1,1,0,0,0,2,"EDI DataOne",2,1,1,3
"countperlongline",1,1,1,0,0,0,2,"EDI DataOne",2,1,1,3
"cubiccentimeterspergram",1,1,1,0,0,0,2,"EDI DataOne",2,1,1,3
"dayofyear",1,1,1,0,0,0,2,"EDI DataOne",2,1,1,3
"dd.dd",1,1,1,0,0,0,2,"EDI DataOne",2,1,1,3
"deg-min.dm",1,1,2,0,0,0,1,"EDI DataOne",2,1,1,3
"delta",1,1,2,0,0,0,1,"EDI DataOne",2,1,1,3
"disintegrationsperminuteperliter",1,1,2,0,0,0,1,"EDI DataOne",2,1,1,3
"dps/kg",1,1,1,0,0,0,2,"EDI DataOne",2,1,1,3
"g cm-3",1,1,1,0,0,0,2,"EDI DataOne",2,1,1,3
"gh2o/100gsoil",1,1,1,0,0,0,2,"EDI DataOne",2,1,1,3
"gigagram",1,1,1,0,0,0,2,"EDI DataOne",2,1,1,3
"gigagramperyear",1,1,1,0,0,0,2,"EDI DataOne",2,1,1,3
"gramnoduleperhr",1,1,1,0,0,0,2,"EDI DataOne",2,1,1,3
"grampermeterperday",1,1,2,0,0,0,1,"EDI DataOne",2,1,1,3
"gramspermegapascalpersecondpermeter",1,1,1,0,0,0,2,"EDI DataOne",2,1,1,3
"gramspermole",1,1,1,0,0,0,2,"EDI DataOne",2,1,1,3
"gramspersquaremeterpermonth",1,1,2,0,0,0,1,"EDI DataOne",2,1,1,3
"id #",1,1,2,0,0,0,1,"EDI DataOne",2,1,1,3
"individuals/ha",1,1,1,0,0,0,2,"EDI DataOne",2,1,1,3
"inversemeters",1,1,1,0,0,0,2,"EDI DataOne",2,1,1,3
"kg/sq m.",1,1,2,0,0,0,1,"EDI DataOne",2,1,1,3
"kgm-1s-2",1,1,2,0,0,0,1,"EDI DataOne",2,1,1,3
"kph",1,1,1,0,0,0,2,"EDI DataOne",2,1,1,3
"kwattspermetersquared",1,1,2,0,0,0,1,"EDI DataOne",2,1,1,3
"leafnumberpershortshoot",1,1,1,0,0,0,2,"EDI DataOne",2,1,1,3
"literspermetermilligram",1,1,2,0,0,0,1,"EDI DataOne",2,1,1,3
"lmg-1m-1",1,1,1,0,0,0,2,"EDI DataOne",2,1,1,3
"m2/s",1,1,1,0,0,0,2,"EDI DataOne",2,1,1,3
"m3m-3",1,1,2,0,0,0,1,"EDI DataOne",2,1,1,3
"mg/cm^2",1,1,1,0,0,0,2,"EDI DataOne",2,1,1,3
"microequivalentperliter",1,1,1,0,0,0,2,"EDI DataOne",2,1,1,3
"microgrampersquaremeterperday",1,1,1,0,0,0,2,"EDI DataOne",2,1,1,3
"microgrampertensquarecentimeterperburiallength",1,1,1,0,0,0,2,"EDI DataOne",2,1,1,3
"microgramsperliterperhour",1,1,1,0,0,0,2,"EDI DataOne",2,1,1,3
"micromolepersquarecentimeter",1,1,2,0,0,0,1,"EDI DataOne",2,1,1,3
"milligramperdeciliter",1,1,2,0,0,0,1,"EDI DataOne",2,1,1,3
"milligramspergramperlitter",1,1,1,0,0,0,2,"EDI DataOne",2,1,1,3
"milligramspershortshootperday",1,1,1,0,0,0,2,"EDI DataOne",2,1,1,3
"mm2/year",1,1,1,0,0,0,2,"EDI DataOne",2,1,1,3
"mo",1,1,1,0,0,0,2,"EDI DataOne",2,1,1,3
"moles",1,1,1,0,0,0,2,"EDI DataOne",2,1,1,3
"nag: b-1,4-n-acetylglucosaminidase nmoles of substrate converted per hour per gram sample dry weight",1,1,1,0,0,0,2,"EDI DataOne",2,1,1,3
"nanomolesperhourpergram",1,1,1,0,0,0,2,"EDI DataOne",2,1,1,3
"nanomolspergrampersecond",1,1,1,0,0,0,2,"EDI DataOne",2,1,1,3
"nominalhalfhour",1,1,1,0,0,0,2,"EDI DataOne",2,1,1,3
"numbertrees/m2",1,1,1,0,0,0,2,"EDI DataOne",2,1,1,3
"pci/kg",1,1,1,0,0,0,2,"EDI DataOne",2,1,1,3
"pci/pci",1,1,1,0,0,0,2,"EDI DataOne",2,1,1,3
"peroxidase activity in umoles of substrate converted per hour per gram sample dry weight",1,1,1,0,0,0,2,"EDI DataOne",2,1,1,3
"precent",1,1,2,0,0,0,1,"EDI DataOne",2,1,1,3
"shortshootpersquaremeter",1,1,1,0,0,0,2,"EDI DataOne",2,1,1,3
"squarecentimeterspershortshootperday",1,1,1,0,0,0,2,"EDI DataOne",2,1,1,3
"thousands per acre",1,1,1,0,0,0,2,"EDI DataOne",2,1,1,3
"tonnesperacre",1,1,1,0,0,0,2,"EDI DataOne",2,1,1,3
"tonsperacrefeet",1,1,1,0,0,0,2,"EDI DataOne",2,1,1,3
"tonsperday",1,1,1,0,0,0,2,"EDI DataOne",2,1,1,3
"ug/l",1,1,2,0,0,0,1,"EDI DataOne",2,1,1,3
"ugnh4-n/gsoil",1,1,2,0,0,0,1,"EDI DataOne",2,1,1,3
"um m-2",1,1,2,0,0,0,1,"EDI DataOne",2,1,1,3
"umol n/g",1,1,1,0,0,0,2,"EDI DataOne",2,1,1,3
"usec",1,1,2,0,0,0,1,"EDI DataOne",2,1,1,3
"volts",1,1,1,0,0,0,2,"EDI DataOne",2,1,1,3
"millimetersofmercury",1,1,1,1,1,1,0,"EDI NEON",2,2,2,2
"0.2wattpermetersquaredpermillivolt",1,1,1,0,0,0,1,"EDI DataOne",2,1,1,2
"1",1,1,1,0,0,0,1,"EDI DataOne",2,1,1,2
"angstrom",1,1,1,0,0,0,1,"EDI DataOne",2,1,1,2
"atms",1,1,1,0,0,0,1,"EDI DataOne",2,1,1,2
"bits/cm3",1,1,1,0,0,0,1,"EDI DataOne",2,1,1,2
"centimetercubedpergram*100",1,1,1,0,0,0,1,"EDI DataOne",2,1,1,2
"centimetersquaredpersecond",1,1,1,0,0,0,1,"EDI DataOne",2,1,1,2
"cm2/cm2",1,1,1,0,0,0,1,"EDI DataOne",2,1,1,2
"co2-c/gsoilc",1,1,1,0,0,0,1,"EDI DataOne",2,1,1,2
"countpermeter",1,1,1,0,0,0,1,"EDI DataOne",2,1,1,2
"counts and percentages",1,1,1,0,0,0,1,"EDI DataOne",2,1,1,2
"cubickilometers",1,1,1,0,0,0,1,"EDI DataOne",2,1,1,2
"cubicmeterpersquaremeter",1,1,1,0,0,0,1,"EDI DataOne",2,1,1,2
"datetime",1,1,1,0,0,0,1,"EDI DataOne",2,1,1,2
"dec. degr.",1,1,1,0,0,0,1,"EDI DataOne",2,1,1,2
"decimaldegreesnorthofequator",1,1,1,0,0,0,1,"EDI DataOne",2,1,1,2
"decimaldegreeswestofprimemeridian",1,1,1,0,0,0,1,"EDI DataOne",2,1,1,2
"degeee",1,1,1,0,0,0,1,"EDI DataOne",2,1,1,2
"degreesfromhorzontal",1,1,1,0,0,0,1,"EDI DataOne",2,1,1,2
"degreesfromtruenorth",1,1,1,0,0,0,1,"EDI DataOne",2,1,1,2
"degreeslatitude",1,1,1,0,0,0,1,"EDI DataOne",2,1,1,2
"degreeslongitude",1,1,1,0,0,0,1,"EDI DataOne",2,1,1,2
"del18o",1,1,1,0,0,0,1,"EDI DataOne",2,1,1,2
"delta14c",1,1,1,0,0,0,1,"EDI DataOne",2,1,1,2
"disintegrations per minute per gram",1,1,1,0,0,0,1,"EDI DataOne",2,1,1,2
"disintegrationsperminutepergram",1,1,1,0,0,0,1,"EDI DataOne",2,1,1,2
"dnbrscaledby1000",1,1,1,0,0,0,1,"EDI DataOne",2,1,1,2
"einsteinpermetersquaredperday",1,1,1,0,0,0,1,"EDI DataOne",2,1,1,2
"feet.inches",1,1,1,0,0,0,1,"EDI DataOne",2,1,1,2
"formazin nephelometric units",1,1,1,0,0,0,1,"EDI DataOne",2,1,1,2
"g*(m^-2*s^-1",1,1,1,0,0,0,1,"EDI DataOne",2,1,1,2
"g*cm^-3",1,1,1,0,0,0,1,"EDI DataOne",2,1,1,2
"g/m2/y",1,1,1,0,0,0,1,"EDI DataOne",2,1,1,2
"gc/m2soil",1,1,1,0,0,0,1,"EDI DataOne",2,1,1,2
"gdrysoil/m3soil",1,1,1,0,0,0,1,"EDI DataOne",2,1,1,2
"gh2o/gdrysoil",1,1,1,0,0,0,1,"EDI DataOne",2,1,1,2
"gm/cm3",1,1,1,0,0,0,1,"EDI DataOne",2,1,1,2
"gm/m2",1,1,1,0,0,0,1,"EDI DataOne",2,1,1,2
"gn/m2soil",1,1,1,0,0,0,1,"EDI DataOne",2,1,1,2
"gramperplant",1,1,1,0,0,0,1,"EDI DataOne",2,1,1,2
"grams per meter squared per second",1,1,1,0,0,0,1,"EDI DataOne",2,1,1,2
"gramsper2by2inchby25centimetersdeep",1,1,1,0,0,0,1,"EDI DataOne",2,1,1,2
"gramspergramsperday",1,1,1,0,0,0,1,"EDI DataOne",2,1,1,2
"gramsperhetare",1,1,1,0,0,0,1,"EDI DataOne",2,1,1,2
"gramsperonequartermetersquared",1,1,1,0,0,0,1,"EDI DataOne",2,1,1,2
"gramspersecond",1,1,1,0,0,0,1,"EDI DataOne",2,1,1,2
"hr",1,1,1,0,0,0,1,"EDI DataOne",2,1,1,2
"julian day",1,1,1,0,0,0,1,"EDI DataOne",2,1,1,2
"kg/ha",1,1,1,0,0,0,1,"EDI DataOne",2,1,1,2
"kilogramperhourperperson",1,1,1,0,0,0,1,"EDI DataOne",2,1,1,2
"kilohertz",1,1,1,0,0,0,1,"EDI DataOne",2,1,1,2
"kilojoulepergram",1,1,1,0,0,0,1,"EDI DataOne",2,1,1,2
"kilopascals",1,1,1,0,0,0,1,"EDI DataOne",2,1,1,2
"kilowattsperhourpermetersquare",1,1,1,0,0,0,1,"EDI DataOne",2,1,1,2
"langley",1,1,1,0,0,0,1,"EDI DataOne",2,1,1,2
"literpermilligramcarbonpermeter",1,1,1,0,0,0,1,"EDI DataOne",2,1,1,2
"luminperfootsquared",1,1,1,0,0,0,1,"EDI DataOne",2,1,1,2
"m3ha-1",1,1,1,0,0,0,1,"EDI DataOne",2,1,1,2
"m3m-2",1,1,1,0,0,0,1,"EDI DataOne",2,1,1,2
"megajoulespersquaremeter",1,1,1,0,0,0,1,"EDI DataOne",2,1,1,2
"meq/l",1,1,1,0,0,0,1,"EDI DataOne",2,1,1,2
"meq/l",1,1,1,0,0,0,1,"EDI DataOne",2,1,1,2
"metercubedperhundredmeters",1,1,1,0,0,0,1,"EDI DataOne",2,1,1,2
"meters per day",1,1,1,0,0,0,1,"EDI DataOne",2,1,1,2
"metersabovesealevel",1,1,1,0,0,0,1,"EDI DataOne",2,1,1,2
"metersquaredpersecondcubed",1,1,1,0,0,0,1,"EDI DataOne",2,1,1,2
"meterssquared per hectar",1,1,1,0,0,0,1,"EDI DataOne",2,1,1,2
"mg chl-a/kg soil",1,1,1,0,0,0,1,"EDI DataOne",2,1,1,2
"mg/(m2*day",1,1,1,0,0,0,1,"EDI DataOne",2,1,1,2
"mg/m2/d",1,1,1,0,0,0,1,"EDI DataOne",2,1,1,2
"mg/m2/h",1,1,1,0,0,0,1,"EDI DataOne",2,1,1,2
"mgbsaproteinprecipitatedpergleafdrymass",1,1,1,0,0,0,1,"EDI DataOne",2,1,1,2
"mgc/gdrysoil/day",1,1,1,0,0,0,1,"EDI DataOne",2,1,1,2
"mgc/gsoilc/day",1,1,1,0,0,0,1,"EDI DataOne",2,1,1,2
"mgc/m2",1,1,1,0,0,0,1,"EDI DataOne",2,1,1,2
"mgco2/sec/groot",1,1,1,0,0,0,1,"EDI DataOne",2,1,1,2
"mgco2/sec/m2",1,1,1,0,0,0,1,"EDI DataOne",2,1,1,2
"mgcpergleafdrymass",1,1,1,0,0,0,1,"EDI DataOne",2,1,1,2
"mgm-3",1,1,1,0,0,0,1,"EDI DataOne",2,1,1,2
"mgn/m2/h",1,1,1,0,0,0,1,"EDI DataOne",2,1,1,2
"mgnm2/h",1,1,1,0,0,0,1,"EDI DataOne",2,1,1,2
"mgnpergleafdrymass",1,1,1,0,0,0,1,"EDI DataOne",2,1,1,2
"microbecquerelpergram",1,1,1,0,0,0,1,"EDI DataOne",2,1,1,2
"microe/m2/s",1,1,1,0,0,0,1,"EDI DataOne",2,1,1,2
"microgc/cm2/hr",1,1,1,0,0,0,1,"EDI DataOne",2,1,1,2
"microgc/gafdm/hr",1,1,1,0,0,0,1,"EDI DataOne",2,1,1,2
"microgram of carbon per squarecentimeters per hour",1,1,1,0,0,0,1,"EDI DataOne",2,1,1,2
"microgramspercentimetercubed",1,1,1,0,0,0,1,"EDI DataOne",2,1,1,2
"microgramspershortshoot",1,1,1,0,0,0,1,"EDI DataOne",2,1,1,2
"microgramspersquaremeter per second",1,1,1,0,0,0,1,"EDI DataOne",2,1,1,2
"micromole per second",1,1,1,0,0,0,1,"EDI DataOne",2,1,1,2
"micromolesco2pergramnoduleperhour",1,1,1,0,0,0,1,"EDI DataOne",2,1,1,2
"micromolesnpergramnoduleperhour",1,1,1,0,0,0,1,"EDI DataOne",2,1,1,2
"microsiemen",1,1,1,0,0,0,1,"EDI DataOne",2,1,1,2
"microsimmens",1,1,1,0,0,0,1,"EDI DataOne",2,1,1,2
"miligramsperkilogram",1,1,1,0,0,0,1,"EDI DataOne",2,1,1,2
"milimeter",1,1,1,0,0,0,1,"EDI DataOne",2,1,1,2
"milivoltspercentimeter",1,1,1,0,0,0,1,"EDI DataOne",2,1,1,2
"millgramsperkilogram",1,1,1,0,0,0,1,"EDI DataOne",2,1,1,2
"milliequivalentpergram",1,1,1,0,0,0,1,"EDI DataOne",2,1,1,2
"milligramperkilogrampermonth",1,1,1,0,0,0,1,"EDI DataOne",2,1,1,2
"milligrams per meter squared per second",1,1,1,0,0,0,1,"EDI DataOne",2,1,1,2
"milligramsnitrogenperliter",1,1,1,0,0,0,1,"EDI DataOne",2,1,1,2
"milligramspercentimetersquared",1,1,1,0,0,0,1,"EDI DataOne",2,1,1,2
"milligramspergram",1,1,1,0,0,0,1,"EDI DataOne",2,1,1,2
"milligramspergrams",1,1,1,0,0,0,1,"EDI DataOne",2,1,1,2
"milligramsperhour",1,1,1,0,0,0,1,"EDI DataOne",2,1,1,2
"millimeterpernumber",1,1,1,0,0,0,1,"EDI DataOne",2,1,1,2
"millimolesperliter",1,1,1,0,0,0,1,"EDI DataOne",2,1,1,2
"millioncubicmeters",1,1,1,0,0,0,1,"EDI DataOne",2,1,1,2
"min",1,1,1,0,0,0,1,"EDI DataOne",2,1,1,2
"ml",1,1,1,0,0,0,1,"EDI DataOne",2,1,1,2
"mls",1,1,1,0,0,0,1,"EDI DataOne",2,1,1,2
"mm/min",1,1,1,0,0,0,1,"EDI DataOne",2,1,1,2
"molco2m-2s-1",1,1,1,0,0,0,1,"EDI DataOne",2,1,1,2
"ms-1",1,1,1,0,0,0,1,"EDI DataOne",2,1,1,2
"msec-1",1,1,1,0,0,0,1,"EDI DataOne",2,1,1,2
"nanogram of carbon per squarecentimeters per hour",1,1,1,0,0,0,1,"EDI DataOne",2,1,1,2
"nanogram of nitrogen per squarecentimeters per hour",1,1,1,0,0,0,1,"EDI DataOne",2,1,1,2
"nanomolepermolepersecond",1,1,1,0,0,0,1,"EDI DataOne",2,1,1,2
"nanomolesperminute",1,1,1,0,0,0,1,"EDI DataOne",2,1,1,2
"nh4-n/gsoil",1,1,1,0,0,0,1,"EDI DataOne",2,1,1,2
"nm leu/day",1,1,1,0,0,0,1,"EDI DataOne",2,1,1,2
"no data",1,1,1,0,0,0,1,"EDI DataOne",2,1,1,2
"number/liter",1,1,1,0,0,0,1,"EDI DataOne",2,1,1,2
"numberperacre",1,1,1,0,0,0,1,"EDI DataOne",2,1,1,2
"numberpermetersquaredperday",1,1,1,0,0,0,1,"EDI DataOne",2,1,1,2
"numberperyear",1,1,1,0,0,0,1,"EDI DataOne",2,1,1,2
"picogramcarbon",1,1,1,0,0,0,1,"EDI DataOne",2,1,1,2
"picomolespergram",1,1,1,0,0,0,1,"EDI DataOne",2,1,1,2
"plants m-2",1,1,1,0,0,0,1,"EDI DataOne",2,1,1,2
"platinumcobaltunit",1,1,1,0,0,0,1,"EDI DataOne",2,1,1,2
"poreareaperlaminaarea",1,1,1,0,0,0,1,"EDI DataOne",2,1,1,2
"ppm/sec/groot",1,1,1,0,0,0,1,"EDI DataOne",2,1,1,2
"ppm/sec/m3",1,1,1,0,0,0,1,"EDI DataOne",2,1,1,2
"shelledbushelsperacre",1,1,1,0,0,0,1,"EDI DataOne",2,1,1,2
"species denisty/total density",1,1,1,0,0,0,1,"EDI DataOne",2,1,1,2
"squaremeterspergram",1,1,1,0,0,0,1,"EDI DataOne",2,1,1,2
"standardcubicfoot",1,1,1,0,0,0,1,"EDI DataOne",2,1,1,2
"thermalsensitivity",1,1,1,0,0,0,1,"EDI DataOne",2,1,1,2
"thousandboardfootperacre",1,1,1,0,0,0,1,"EDI DataOne",2,1,1,2
"ug chl-a/kg soil",1,1,1,0,0,0,1,"EDI DataOne",2,1,1,2
"ugchlorophyll-a/liter",1,1,1,0,0,0,1,"EDI DataOne",2,1,1,2
"umolmol-1",1,1,1,0,0,0,1,"EDI DataOne",2,1,1,2
"umolphotonsm-2s-1",1,1,1,0,0,0,1,"EDI DataOne",2,1,1,2
"umolphotonsm-2s-10",1,1,1,0,0,0,1,"EDI DataOne",2,1,1,2
"umolphotonsm-2s-11",1,1,1,0,0,0,1,"EDI DataOne",2,1,1,2
"umolphotonsm-2s-12",1,1,1,0,0,0,1,"EDI DataOne",2,1,1,2
"umolphotonsm-2s-2",1,1,1,0,0,0,1,"EDI DataOne",2,1,1,2
"umolphotonsm-2s-3",1,1,1,0,0,0,1,"EDI DataOne",2,1,1,2
"umolphotonsm-2s-4",1,1,1,0,0,0,1,"EDI DataOne",2,1,1,2
"umolphotonsm-2s-5",1,1,1,0,0,0,1,"EDI DataOne",2,1,1,2
"umolphotonsm-2s-6",1,1,1,0,0,0,1,"EDI DataOne",2,1,1,2
"umolphotonsm-2s-7",1,1,1,0,0,0,1,"EDI DataOne",2,1,1,2
"umolphotonsm-2s-8",1,1,1,0,0,0,1,"EDI DataOne",2,1,1,2
"umolphotonsm-2s-9",1,1,1,0,0,0,1,"EDI DataOne",2,1,1,2
"vol",1,1,1,0,0,0,1,"EDI DataOne",2,1,1,2
"voltsecond",1,1,1,0,0,0,1,"EDI DataOne",2,1,1,2
"water year",1,1,1,0,0,0,1,"EDI DataOne",2,1,1,2
"water year",1,1,1,0,0,0,1,"EDI DataOne",2,1,1,2
"years",1,1,1,0,0,0,1,"EDI DataOne",2,1,1,2
"yyyy-mm-dd",1,1,1,0,0,0,1,"EDI DataOne",2,1,1,2
"degreecelcius",1,196,968,0,0,0,0,"EDI",1,1,196,968
"microsiemens",4,79,629,0,0,0,0,"EDI",1,4,79,629
"cubiccentimeterspercubiccentimeter",0,0,0,1,1,400,0,"NEON",1,1,1,400
"gramsperhectare",2,19,388,0,0,0,0,"EDI",1,2,19,388
"2",0,0,0,0,0,0,323,"DataOne",1,0,0,323
"pct areal cover",1,2,322,0,0,0,0,"EDI",1,1,2,322
"0",0,0,0,0,0,0,305,"DataOne",1,0,0,305
"individuals per 30 square meters",0,0,0,0,0,0,282,"DataOne",1,0,0,282
"mph",0,0,0,0,0,0,273,"DataOne",1,0,0,273
"3",0,0,0,0,0,0,263,"DataOne",1,0,0,263
"nanomolepergram",4,9,262,0,0,0,0,"EDI",1,4,9,262
"gramperday",3,3,228,0,0,0,0,"EDI",1,3,3,228
"4",0,0,0,0,0,0,226,"DataOne",1,0,0,226
"unadjustedusdollars",0,0,0,0,0,0,213,"DataOne",1,0,0,213
"decimal degrees",0,0,0,0,0,0,208,"DataOne",1,0,0,208
"5",0,0,0,0,0,0,192,"DataOne",1,0,0,192
"kilograms per catchment",0,0,0,0,0,0,185,"DataOne",1,0,0,185
"micromolepergram",7,14,168,0,0,0,0,"EDI",1,7,14,168
"nd",0,0,0,0,0,0,159,"DataOne",1,0,0,159
"quantity",0,0,0,0,0,0,155,"DataOne",1,0,0,155
"micromolspermetresquaredpersecond",0,0,0,0,0,0,153,"DataOne",1,0,0,153
"weight percent",0,0,0,0,0,0,152,"DataOne",1,0,0,152
"money",0,0,0,0,0,0,122,"DataOne",1,0,0,122
"integer count",0,0,0,0,0,0,116,"DataOne",1,0,0,116
"g^m2",0,0,0,0,0,0,113,"DataOne",1,0,0,113
"catchperuniteffort",1,1,112,0,0,0,0,"EDI",1,1,1,112
"numberper0.1millimetercubed",1,1,110,0,0,0,0,"EDI",1,1,1,110
"microsatellite allele scores (i.e. the length of the gene sequence in base pairs) for each locus across all samples",0,0,0,0,0,0,108,"DataOne",1,0,0,108
"microgramscarbonpermetercubed",1,1,105,0,0,0,0,"EDI",1,1,1,105
"microequivalentspersquaremeterperday",0,0,0,0,0,0,105,"DataOne",1,0,0,105
"nanogramperliter",2,3,103,0,0,0,0,"EDI",1,2,3,103
"positive numbers, no data = blank",0,0,0,0,0,0,95,"DataOne",1,0,0,95
"numberper100milliliters",1,1,90,0,0,0,0,"EDI",1,1,1,90
"cubiccentimeterspercubiccentimetersquared",0,0,0,1,1,80,0,"NEON",1,1,1,80
"base pairs",0,0,0,0,0,0,78,"DataOne",1,0,0,78
"millisiemenspercentimeter",1,5,73,0,0,0,0,"EDI",1,1,5,73
"metersperhectare",2,7,70,0,0,0,0,"EDI",1,2,7,70
"cation number based on 22 oxygen equivalents per formula unit",0,0,0,0,0,0,68,"DataOne",1,0,0,68
"kilograms per hectare",1,2,66,0,0,0,0,"EDI",1,1,2,66
"n",0,0,0,0,0,0,65,"DataOne",1,0,0,65
"milligramperlitter",0,0,0,0,0,0,64,"DataOne",1,0,0,64
"sand",0,0,0,0,0,0,63,"DataOne",1,0,0,63
"millimetersperyear",3,8,61,0,0,0,0,"EDI",1,3,8,61
"cm/s",0,0,0,0,0,0,60,"DataOne",1,0,0,60
"pa",0,0,0,0,0,0,60,"DataOne",1,0,0,60
"""hr""or""normalizedconcentration""",1,1,59,0,0,0,0,"EDI",1,1,1,59
"weight percent (wt%)",0,0,0,0,0,0,58,"DataOne",1,0,0,58
"y",0,0,0,0,0,0,58,"DataOne",1,0,0,58
"micrograms per kilogram (î¼g/kg)",0,0,0,0,0,0,57,"DataOne",1,0,0,57
"oxide weight percent",0,0,0,0,0,0,56,"DataOne",1,0,0,56
"meters per year",0,0,0,0,0,0,55,"DataOne",1,0,0,55
"numberpercentimetersquaredperyear",2,16,53,0,0,0,0,"EDI",1,2,16,53
"gravel",0,0,0,0,0,0,51,"DataOne",1,0,0,51
"kpa",0,0,0,0,0,0,51,"DataOne",1,0,0,51
"numstems",1,1,50,0,0,0,0,"EDI",1,1,1,50
"umolpersecondspermetersquared",1,1,50,0,0,0,0,"EDI",1,1,1,50
"centimetersquaredperfourhundredthmetersquared",1,4,49,0,0,0,0,"EDI",1,1,4,49
"c",0,0,0,0,0,0,49,"DataOne",1,0,0,49
"micromolpersecondpermeterssquared",0,0,0,0,0,0,48,"DataOne",1,0,0,48
"percentsaturation",2,9,47,0,0,0,0,"EDI",1,2,9,47
"gravelly sediment",0,0,0,0,0,0,47,"DataOne",1,0,0,47
"micrograms per liter (âµg/l)",0,0,0,0,0,0,47,"DataOne",1,0,0,47
"areal percentage",1,2,46,0,0,0,0,"EDI",1,1,2,46
"6",0,0,0,0,0,0,46,"DataOne",1,0,0,46
"meters",0,0,0,0,0,0,46,"DataOne",1,0,0,46
"mole percent (mol%)",0,0,0,0,0,0,44,"DataOne",1,0,0,44
"silty sand",0,0,0,0,0,0,44,"DataOne",1,0,0,44
"partspermillion",1,4,41,0,0,0,0,"EDI",1,1,4,41
"equivalentsperhectare",1,2,41,0,0,0,0,"EDI",1,1,2,41
"countofabundance",1,1,41,0,0,0,0,"EDI",1,1,1,41
"decimaldegrees",3,15,40,0,0,0,0,"EDI",1,3,15,40
"-99",0,0,0,0,0,0,40,"DataOne",1,0,0,40
"microgrampergramperhour",4,6,39,0,0,0,0,"EDI",1,4,6,39
"# / kg drysoil",1,1,37,0,0,0,0,"EDI",1,1,1,37
"nt",0,0,0,0,0,0,37,"DataOne",1,0,0,37
"tritiumunit",1,18,36,0,0,0,0,"EDI",1,1,18,36
"link",1,9,36,0,0,0,0,"EDI",1,1,9,36
"kilogramperhectareperyear",3,5,36,0,0,0,0,"EDI",1,3,5,36
"mgkg-1",1,2,36,0,0,0,0,"EDI",1,1,2,36
"u.s. dollar",1,2,36,0,0,0,0,"EDI",1,1,2,36
"milligrams per gram of oil (mg/g oil)",0,0,0,0,0,0,36,"DataOne",1,0,0,36
"millimolspermetresquaredpersecond",0,0,0,0,0,0,36,"DataOne",1,0,0,36
"milligrams per kilogram (mg/kg)",0,0,0,0,0,0,35,"DataOne",1,0,0,35
"np",0,0,0,0,0,0,35,"DataOne",1,0,0,35
"kilometers",0,0,0,0,0,0,34,"DataOne",1,0,0,34
"unadjustedusdollar",0,0,0,0,0,0,34,"DataOne",1,0,0,34
"relativefluorescenceunits",2,12,33,0,0,0,0,"EDI",1,2,12,33
"abundance/m2",1,1,33,0,0,0,0,"EDI",1,1,1,33
"basal area",1,1,33,0,0,0,0,"EDI",1,1,1,33
"biomass",1,1,33,0,0,0,0,"EDI",1,1,1,33
"density",1,1,33,0,0,0,0,"EDI",1,1,1,33
"inverseangstrom",1,1,33,0,0,0,0,"EDI",1,1,1,33
"clayey silt",0,0,0,0,0,0,33,"DataOne",1,0,0,33
"parts per million",0,0,0,0,0,0,32,"DataOne",1,0,0,32
"wattspersquaremetersquared",0,0,0,4,6,31,0,"NEON",1,4,6,31
"snailspermetersquared",1,1,31,0,0,0,0,"EDI",1,1,1,31
"each",0,0,0,0,0,0,31,"DataOne",1,0,0,31
"phi size",0,0,0,0,0,0,31,"DataOne",1,0,0,31
"sandy silt",0,0,0,0,0,0,31,"DataOne",1,0,0,31
"partspermillionsquared",0,0,0,1,1,30,0,"NEON",1,1,1,30
"f",0,0,0,0,0,0,30,"DataOne",1,0,0,30
"microgramperlitter",0,0,0,0,0,0,30,"DataOne",1,0,0,30
"sand silt clay",0,0,0,0,0,0,30,"DataOne",1,0,0,30
"joulepercentimetersquaredperday",1,22,29,0,0,0,0,"EDI",1,1,22,29
"milligramperkilogramperday",3,8,29,0,0,0,0,"EDI",1,3,8,29
"inchesperyear",2,6,29,0,0,0,0,"EDI",1,2,6,29
"becquerelperliter",2,3,29,0,0,0,0,"EDI",1,2,3,29
"microgramperkilogram",1,1,29,0,0,0,0,"EDI",1,1,1,29
"7",0,0,0,0,0,0,29,"DataOne",1,0,0,29
"milligrams per liter (mg/l)",0,0,0,0,0,0,29,"DataOne",1,0,0,29
"micromolespersquaremeterpersecondsquared",0,0,0,3,4,28,0,"NEON",1,3,4,28
"micrograms per liter  (âµg/l)",0,0,0,0,0,0,28,"DataOne",1,0,0,28
"s",0,0,0,0,0,0,28,"DataOne",1,0,0,28
"millisiemenspercentimeter",1,5,27,0,0,0,0,"EDI",1,1,5,27
"m^3/m^3",1,1,27,0,0,0,0,"EDI",1,1,1,27
"millimetersperhour",0,0,0,0,0,0,27,"DataOne",1,0,0,27
"millimolespermetresquaredpersecond",0,0,0,0,0,0,27,"DataOne",1,0,0,27
"null",0,0,0,0,0,0,27,"DataOne",1,0,0,27
"kilogramsperyear",1,1,26,0,0,0,0,"EDI",1,1,1,26
"numberpercubicmeter",1,1,26,0,0,0,0,"EDI",1,1,1,26
"10",0,0,0,0,0,0,26,"DataOne",1,0,0,26
"million gallons per day",0,0,0,0,0,0,26,"DataOne",1,0,0,26
"na",0,0,0,0,0,0,26,"DataOne",1,0,0,26
"whole element counts",0,0,0,0,0,0,26,"DataOne",1,0,0,26
"decimalpercent",3,8,25,0,0,0,0,"EDI",1,3,8,25
"unitless values or unit unknown or not reported",1,5,25,0,0,0,0,"EDI",1,1,5,25
"signed decimal degrees",0,0,0,0,0,0,25,"DataOne",1,0,0,25
"thousandsoftonnes",0,0,0,0,0,0,25,"DataOne",1,0,0,25
"mmol/m^2/s",1,1,24,0,0,0,0,"EDI",1,1,1,24
"absorption percent",0,0,0,0,0,0,24,"DataOne",1,0,0,24
"information unavailable from original metadata.",0,0,0,0,0,0,24,"DataOne",1,0,0,24
"microsiemenspercentimeter",0,0,0,0,0,0,24,"DataOne",1,0,0,24
"molspermetresquaredpersecond",0,0,0,0,0,0,24,"DataOne",1,0,0,24
"percentage (%)",0,0,0,0,0,0,24,"DataOne",1,0,0,24
"electronvolt",1,1,23,0,0,0,0,"EDI",1,1,1,23
"8",0,0,0,0,0,0,23,"DataOne",1,0,0,23
"log of percent",0,0,0,0,0,0,23,"DataOne",1,0,0,23
"time",0,0,0,0,0,0,23,"DataOne",1,0,0,23
"2010",0,0,0,0,0,0,22,"DataOne",1,0,0,22
"g",0,0,0,0,0,0,22,"DataOne",1,0,0,22
"micromols per mol",0,0,0,0,0,0,22,"DataOne",1,0,0,22
"silt",0,0,0,0,0,0,22,"DataOne",1,0,0,22
"silty clay",0,0,0,0,0,0,22,"DataOne",1,0,0,22
"small seaboss grab",0,0,0,0,0,0,22,"DataOne",1,0,0,22
"9",0,0,0,0,0,0,21,"DataOne",1,0,0,21
"blank",0,0,0,0,0,0,21,"DataOne",1,0,0,21
"log of square kilometers",0,0,0,0,0,0,21,"DataOne",1,0,0,21
"shot",0,0,0,0,0,0,21,"DataOne",1,0,0,21
"shot number",0,0,0,0,0,0,21,"DataOne",1,0,0,21
"variable",1,5,20,0,0,0,0,"EDI",1,1,5,20
"metersperyear",3,4,20,0,0,0,0,"EDI",1,3,4,20
"%cover",1,2,20,0,0,0,0,"EDI",1,1,2,20
"watt per m2",1,2,20,0,0,0,0,"EDI",1,1,2,20
"identification number",1,1,20,0,0,0,0,"EDI",1,1,1,20
"11",0,0,0,0,0,0,20,"DataOne",1,0,0,20
"e",0,0,0,0,0,0,20,"DataOne",1,0,0,20
"feet",0,0,0,0,0,0,20,"DataOne",1,0,0,20
"milligrams per liter (mg/l)",0,0,0,0,0,0,20,"DataOne",1,0,0,20
"hectopascal",4,10,19,0,0,0,0,"EDI",1,4,10,19
"cellspermilliliter",3,7,19,0,0,0,0,"EDI",1,3,7,19
"micromolepermetersquaredpersecond",2,3,19,0,0,0,0,"EDI",1,2,3,19
"millimeterpermetersquared",1,1,19,0,0,0,0,"EDI",1,1,1,19
"b",0,0,0,0,0,0,19,"DataOne",1,0,0,19
"clayey sand",0,0,0,0,0,0,19,"DataOne",1,0,0,19
"milligrams per liter (mg/l)",0,0,0,0,0,0,19,"DataOne",1,0,0,19
"neg",0,0,0,0,0,0,19,"DataOne",1,0,0,19
"sum mm per day",1,1,18,0,0,0,0,"EDI",1,1,1,18
"umol/m^2/s",1,1,18,0,0,0,0,"EDI",1,1,1,18
"clay",0,0,0,0,0,0,18,"DataOne",1,0,0,18
"lpoppe",0,0,0,0,0,0,18,"DataOne",1,0,0,18
"parts per million by weight",0,0,0,0,0,0,18,"DataOne",1,0,0,18
"true",0,0,0,0,0,0,18,"DataOne",1,0,0,18
"unitless digital value",0,0,0,0,0,0,18,"DataOne",1,0,0,18
"millimetersperhour",3,7,17,0,0,0,0,"EDI",1,3,7,17
"centimoleschargeperkilogram",0,0,0,2,2,17,0,"NEON",1,2,2,17
"nanogram",2,2,17,0,0,0,0,"EDI",1,2,2,17
"stems/quadrant",1,1,17,0,0,0,0,"EDI",1,1,1,17
"<",0,0,0,0,0,0,17,"DataOne",1,0,0,17
"12",0,0,0,0,0,0,17,"DataOne",1,0,0,17
"a",0,0,0,0,0,0,17,"DataOne",1,0,0,17
"false",0,0,0,0,0,0,17,"DataOne",1,0,0,17
"meters/month",0,0,0,0,0,0,17,"DataOne",1,0,0,17
"meters/second",0,0,0,0,0,0,17,"DataOne",1,0,0,17
"micromhos/cm",0,0,0,0,0,0,17,"DataOne",1,0,0,17
"bars",3,3,16,0,0,0,0,"EDI",1,3,3,16
"millimetercubedpermetersquared",1,1,16,0,0,0,0,"EDI",1,1,1,16
"shoot density/0.25m2",1,1,16,0,0,0,0,"EDI",1,1,1,16
"square centimeters",1,1,16,0,0,0,0,"EDI",1,1,1,16
"tillers per 0.25 squaremeter",1,1,16,0,0,0,0,"EDI",1,1,1,16
"wattperwattpersteradian",1,1,16,0,0,0,0,"EDI",1,1,1,16
"mj/m2",0,0,0,0,0,0,16,"DataOne",1,0,0,16
"numberper1130m2",0,0,0,0,0,0,16,"DataOne",1,0,0,16
"open ocean",0,0,0,0,0,0,16,"DataOne",1,0,0,16
"p",0,0,0,0,0,0,16,"DataOne",1,0,0,16
"sequential numbers",0,0,0,0,0,0,16,"DataOne",1,0,0,16
"usdpermetrictonne",0,0,0,0,0,0,16,"DataOne",1,0,0,16
"usgs",0,0,0,0,0,0,16,"DataOne",1,0,0,16
"microgrampercentimetercubed",2,6,15,0,0,0,0,"EDI",1,2,6,15
"g/0.625m2",1,5,15,0,0,0,0,"EDI",1,1,5,15
"microgrampermilliliter",2,5,15,0,0,0,0,"EDI",1,2,5,15
"gcarbon/m^2",1,2,15,0,0,0,0,"EDI",1,1,2,15
"megagramsperhectare",1,1,15,0,0,0,0,"EDI",1,1,1,15
"cycle threshold (ct)",0,0,0,0,0,0,15,"DataOne",1,0,0,15
"d",0,0,0,0,0,0,15,"DataOne",1,0,0,15
"date",0,0,0,0,0,0,15,"DataOne",1,0,0,15
"degrees celsius",0,0,0,0,0,0,15,"DataOne",1,0,0,15
"feet (0.1')",0,0,0,0,0,0,15,"DataOne",1,0,0,15
"lidar",0,0,0,0,0,0,15,"DataOne",1,0,0,15
"mole percent",0,0,0,0,0,0,15,"DataOne",1,0,0,15
"noaa",0,0,0,0,0,0,15,"DataOne",1,0,0,15
"sandy clay",0,0,0,0,0,0,15,"DataOne",1,0,0,15
"t or tp with number",0,0,0,0,0,0,15,"DataOne",1,0,0,15
"tunits",0,0,0,0,0,0,15,"DataOne",1,0,0,15
"yes",0,0,0,0,0,0,15,"DataOne",1,0,0,15
"kiloamperes",1,14,14,0,0,0,0,"EDI",1,1,14,14
"gramperkilogram",4,8,14,0,0,0,0,"EDI",1,4,8,14
"hectopascal",2,5,14,0,0,0,0,"EDI",1,2,5,14
"nanomolesperliter",1,2,14,0,0,0,0,"EDI",1,1,2,14
"abundance",1,1,14,0,0,0,0,"EDI",1,1,1,14
"micro siemens/cm",1,1,14,0,0,0,0,"EDI",1,1,1,14
"micromolepermolepermetersquaredpersecond",1,1,14,0,0,0,0,"EDI",1,1,1,14
"micromolesquaredpermolesquared",1,1,14,0,0,0,0,"EDI",1,1,1,14
"microwatts",1,1,14,0,0,0,0,"EDI",1,1,1,14
"millisecondsquared",1,1,14,0,0,0,0,"EDI",1,1,1,14
"mm per day",1,1,14,0,0,0,0,"EDI",1,1,1,14
"percent as decimal ",1,1,14,0,0,0,0,"EDI",1,1,1,14
"quininesulfateunits",1,1,14,0,0,0,0,"EDI",1,1,1,14
"stems/plot",1,1,14,0,0,0,0,"EDI",1,1,1,14
"tonneperyear",1,1,14,0,0,0,0,"EDI",1,1,1,14
"us dollar",1,1,14,0,0,0,0,"EDI",1,1,1,14
"date and time in mm/dd/yyyy hh:mm:ss.fff format",0,0,0,0,0,0,14,"DataOne",1,0,0,14
"decigram",0,0,0,0,0,0,14,"DataOne",1,0,0,14
"delta vs v-smow.",0,0,0,0,0,0,14,"DataOne",1,0,0,14
"dpm/g",0,0,0,0,0,0,14,"DataOne",1,0,0,14
"grams carbon per square meter",0,0,0,0,0,0,14,"DataOne",1,0,0,14
"micromol per mol",0,0,0,0,0,0,14,"DataOne",1,0,0,14
"per mil (â€°)",0,0,0,0,0,0,14,"DataOne",1,0,0,14
"micrograms per gram per hour",1,5,13,0,0,0,0,"EDI",1,1,5,13
"milligramspermetersquaredpersecond",1,3,13,0,0,0,0,"EDI",1,1,3,13
"gramspersquaremeterperhour",2,2,13,0,0,0,0,"EDI",1,2,2,13
"metercubedperday",2,2,13,0,0,0,0,"EDI",1,2,2,13
"tonnesperyear",2,2,13,0,0,0,0,"EDI",1,2,2,13
"milligramspermilligram",1,1,13,0,0,0,0,"EDI",1,1,1,13
"partpertrillion",1,1,13,0,0,0,0,"EDI",1,1,1,13
"{null value / empty field entry}",0,0,0,0,0,0,13,"DataOne",1,0,0,13
"degrees celcius",0,0,0,0,0,0,13,"DataOne",1,0,0,13
"julian day",0,0,0,0,0,0,13,"DataOne",1,0,0,13
"no",0,0,0,0,0,0,13,"DataOne",1,0,0,13
"sample id for samples selected for lab.",0,0,0,0,0,0,13,"DataOne",1,0,0,13
"yes",0,0,0,0,0,0,13,"DataOne",1,0,0,13
"micromhospercentimeter",2,9,12,0,0,0,0,"EDI",1,2,9,12
"number of days",2,5,12,0,0,0,0,"EDI",1,2,5,12
"millimoleoxygenpermetersquaredperday",1,4,12,0,0,0,0,"EDI",1,1,4,12
"millimoleperliter",2,4,12,0,0,0,0,"EDI",1,2,4,12
"relativefluorescenceunits",1,4,12,0,0,0,0,"EDI",1,1,4,12
"formazinnephelometricunit",2,3,12,0,0,0,0,"EDI",1,2,3,12
"megagram",2,3,12,0,0,0,0,"EDI",1,2,3,12
"cubic feet per second per square mile",1,2,12,0,0,0,0,"EDI",1,1,2,12
"gnitrogen/m^2",1,2,12,0,0,0,0,"EDI",1,1,2,12
"jouleperday",2,2,12,0,0,0,0,"EDI",1,2,2,12
"millequivalentsper100grams",1,2,12,0,0,0,0,"EDI",1,1,2,12
"milligramperliterperhour",1,2,12,0,0,0,0,"EDI",1,1,2,12
"units per square kilometer",1,2,12,0,0,0,0,"EDI",1,1,2,12
"units per square km",1,2,12,0,0,0,0,"EDI",1,1,2,12
"# / g dry litter",1,1,12,0,0,0,0,"EDI",1,1,1,12
".01 ft",1,1,12,0,0,0,0,"EDI",1,1,1,12
"arbitraryunits",1,1,12,0,0,0,0,"EDI",1,1,1,12
"g-o2 per m2 per day",1,1,12,0,0,0,0,"EDI",1,1,1,12
"grams carbon per square meter per day or grams carbon per square meter per month",1,1,12,0,0,0,0,"EDI",1,1,1,12
"micro atmosphere",1,1,12,0,0,0,0,"EDI",1,1,1,12
"millimolarity",1,1,12,0,0,0,0,"EDI",1,1,1,12
"relative fluorescence",1,1,12,0,0,0,0,"EDI",1,1,1,12
"-99999",0,0,0,0,0,0,12,"DataOne",1,0,0,12
"(g)m",0,0,0,0,0,0,12,"DataOne",1,0,0,12
"(g)ms",0,0,0,0,0,0,12,"DataOne",1,0,0,12
"(g)s",0,0,0,0,0,0,12,"DataOne",1,0,0,12
"(g)sm",0,0,0,0,0,0,12,"DataOne",1,0,0,12
"âµmol m-2 s-1",0,0,0,0,0,0,12,"DataOne",1,0,0,12
"acu",0,0,0,0,0,0,12,"DataOne",1,0,0,12
"cmp",0,0,0,0,0,0,12,"DataOne",1,0,0,12
"col",0,0,0,0,0,0,12,"DataOne",1,0,0,12
"erosion or nondeposition",0,0,0,0,0,0,12,"DataOne",1,0,0,12
"gm",0,0,0,0,0,0,12,"DataOne",1,0,0,12
"gms",0,0,0,0,0,0,12,"DataOne",1,0,0,12
"gramsperhundredmeterpersquare",0,0,0,0,0,0,12,"DataOne",1,0,0,12
"grassland",0,0,0,0,0,0,12,"DataOne",1,0,0,12
"grz",0,0,0,0,0,0,12,"DataOne",1,0,0,12
"gs",0,0,0,0,0,0,12,"DataOne",1,0,0,12
"gtc",0,0,0,0,0,0,12,"DataOne",1,0,0,12
"kilometers squared",0,0,0,0,0,0,12,"DataOne",1,0,0,12
"lth",0,0,0,0,0,0,12,"DataOne",1,0,0,12
"meters w.e.",0,0,0,0,0,0,12,"DataOne",1,0,0,12
"mg",0,0,0,0,0,0,12,"DataOne",1,0,0,12
"micrograms per catchment",0,0,0,0,0,0,12,"DataOne",1,0,0,12
"mm3",0,0,0,0,0,0,12,"DataOne",1,0,0,12
"ms",0,0,0,0,0,0,12,"DataOne",1,0,0,12
"msg",0,0,0,0,0,0,12,"DataOne",1,0,0,12
"nanomolespergramspersecond",0,0,0,0,0,0,12,"DataOne",1,0,0,12
"native forest",0,0,0,0,0,0,12,"DataOne",1,0,0,12
"numeric value",0,0,0,0,0,0,12,"DataOne",1,0,0,12
"r",0,0,0,0,0,0,12,"DataOne",1,0,0,12
"sg",0,0,0,0,0,0,12,"DataOne",1,0,0,12
"shrubland",0,0,0,0,0,0,12,"DataOne",1,0,0,12
"sm",0,0,0,0,0,0,12,"DataOne",1,0,0,12
"sparsely vegetated",0,0,0,0,0,0,12,"DataOne",1,0,0,12
"spring",0,0,0,0,0,0,12,"DataOne",1,0,0,12
"sugarcane",0,0,0,0,0,0,12,"DataOne",1,0,0,12
"taro",0,0,0,0,0,0,12,"DataOne",1,0,0,12
"txg",0,0,0,0,0,0,12,"DataOne",1,0,0,12
"txr",0,0,0,0,0,0,12,"DataOne",1,0,0,12
"wetland",0,0,0,0,0,0,12,"DataOne",1,0,0,12
"kilowattpermetersquaredpersecond",1,11,11,0,0,0,0,"EDI",1,1,11,11
"grampermetersquaredpersecond",3,4,11,0,0,0,0,"EDI",1,3,4,11
"nanogrampergramperhour",2,3,11,0,0,0,0,"EDI",1,2,3,11
"number of fish",1,3,11,0,0,0,0,"EDI",1,1,3,11
"# / square meter",1,1,11,0,0,0,0,"EDI",1,1,1,11
"day of year",1,1,11,0,0,0,0,"EDI",1,1,1,11
"gramper0.25metersquare",1,1,11,0,0,0,0,"EDI",1,1,1,11
"part per million",1,1,11,0,0,0,0,"EDI",1,1,1,11
"relativefluorescenceunites",1,1,11,0,0,0,0,"EDI",1,1,1,11
"200m",0,0,0,0,0,0,11,"DataOne",1,0,0,11
"alien forest",0,0,0,0,0,0,11,"DataOne",1,0,0,11
"coarse bedload transport",0,0,0,0,0,0,11,"DataOne",1,0,0,11
"coffee",0,0,0,0,0,0,11,"DataOne",1,0,0,11
"developed, open space",0,0,0,0,0,0,11,"DataOne",1,0,0,11
"diversified agriculture",0,0,0,0,0,0,11,"DataOne",1,0,0,11
"fallow/grassland",0,0,0,0,0,0,11,"DataOne",1,0,0,11
"golf course",0,0,0,0,0,0,11,"DataOne",1,0,0,11
"gray",0,0,0,0,0,0,11,"DataOne",1,0,0,11
"lumen",0,0,0,0,0,0,11,"DataOne",1,0,0,11
"macadamia",0,0,0,0,0,0,11,"DataOne",1,0,0,11
"megagallon",0,0,0,0,0,0,11,"DataOne",1,0,0,11
"mg/dl",0,0,0,0,0,0,11,"DataOne",1,0,0,11
"microgramsperliter",0,0,0,0,0,0,11,"DataOne",1,0,0,11
"milimetersperhour",0,0,0,0,0,0,11,"DataOne",1,0,0,11
"mmol/l",0,0,0,0,0,0,11,"DataOne",1,0,0,11
"ohm-m",0,0,0,0,0,0,11,"DataOne",1,0,0,11
"parts per million (ppm), < indicates value was less than the laboratory reporting level",0,0,0,0,0,0,11,"DataOne",1,0,0,11
"parts per thousand (per mil)",0,0,0,0,0,0,11,"DataOne",1,0,0,11
"pineapple",0,0,0,0,0,0,11,"DataOne",1,0,0,11
"reservoir",0,0,0,0,0,0,11,"DataOne",1,0,0,11
"sediment",0,0,0,0,0,0,11,"DataOne",1,0,0,11
"tree plantation",0,0,0,0,0,0,11,"DataOne",1,0,0,11
"u",0,0,0,0,0,0,11,"DataOne",1,0,0,11
"unadjustedusdollarsperpound",0,0,0,0,0,0,11,"DataOne",1,0,0,11
"usdollarsperpound",0,0,0,0,0,0,11,"DataOne",1,0,0,11
"water body",0,0,0,0,0,0,11,"DataOne",1,0,0,11
"joulepercentimetersquaredperhour",1,10,10,0,0,0,0,"EDI",1,1,10,10
"decimalfraction",1,7,10,0,0,0,0,"EDI",1,1,7,10
"unitless.",1,3,10,0,0,0,0,"EDI",1,1,3,10
"degreessquared",0,0,0,2,2,10,0,"NEON",1,2,2,10
"g/shoot/yr",1,2,10,0,0,0,0,"EDI",1,1,2,10
"gramperyear",1,2,10,0,0,0,0,"EDI",1,1,2,10
"half-acre",1,2,10,0,0,0,0,"EDI",1,1,2,10
"individualsperliter",1,2,10,0,0,0,0,"EDI",1,1,2,10
"nanomoleperhourpergram",1,2,10,0,0,0,0,"EDI",1,1,2,10
"partspermillion",1,2,10,0,0,0,0,"EDI",1,1,2,10
"1/d",1,1,10,0,0,0,0,"EDI",1,1,1,10
"calendarday",1,1,10,0,0,0,0,"EDI",1,1,1,10
"centimenter",1,1,10,0,0,0,0,"EDI",1,1,1,10
"micromoleperdisintegrationperminute",1,1,10,0,0,0,0,"EDI",1,1,1,10
"micromoles/liter",1,1,10,0,0,0,0,"EDI",1,1,1,10
"moles per m2 per day",1,1,10,0,0,0,0,"EDI",1,1,1,10
"numbermicrometercubedper0.1mililiter",1,1,10,0,0,0,0,"EDI",1,1,1,10
"numbermicrometercubedper0.1milimetercubed",1,1,10,0,0,0,0,"EDI",1,1,1,10
"opticaldensity",1,1,10,0,0,0,0,"EDI",1,1,1,10
"umol s-1 m-2",1,1,10,0,0,0,0,"EDI",1,1,1,10
"-",0,0,0,0,0,0,10,"DataOne",1,0,0,10
".",0,0,0,0,0,0,10,"DataOne",1,0,0,10
"acsa2",0,0,0,0,0,0,10,"DataOne",1,0,0,10
"amountpercubicmeter",0,0,0,0,0,0,10,"DataOne",1,0,0,10
"beni",0,0,0,0,0,0,10,"DataOne",1,0,0,10
"boulders",0,0,0,0,0,0,10,"DataOne",1,0,0,10
"ceoc",0,0,0,0,0,0,10,"DataOne",1,0,0,10
"coastal",0,0,0,0,0,0,10,"DataOne",1,0,0,10
"developed, high intensity",0,0,0,0,0,0,10,"DataOne",1,0,0,10
"developed, low intensity",0,0,0,0,0,0,10,"DataOne",1,0,0,10
"developed, medium intensity",0,0,0,0,0,0,10,"DataOne",1,0,0,10
"feed",0,0,0,0,0,0,10,"DataOne",1,0,0,10
"fly",0,0,0,0,0,0,10,"DataOne",1,0,0,10
"frpe",0,0,0,0,0,0,10,"DataOne",1,0,0,10
"gps",0,0,0,0,0,0,10,"DataOne",1,0,0,10
"gramspercentimetercubed",0,0,0,0,0,0,10,"DataOne",1,0,0,10
"integers",0,0,0,0,0,0,10,"DataOne",1,0,0,10
"kg",0,0,0,0,0,0,10,"DataOne",1,0,0,10
"land",0,0,0,0,0,0,10,"DataOne",1,0,0,10
"log(10) of ohm-m",0,0,0,0,0,0,10,"DataOne",1,0,0,10
"microgram/liter",0,0,0,0,0,0,10,"DataOne",1,0,0,10
"no",0,0,0,0,0,0,10,"DataOne",1,0,0,10
"ohm-meter",0,0,0,0,0,0,10,"DataOne",1,0,0,10
"ohms",0,0,0,0,0,0,10,"DataOne",1,0,0,10
"on txs",0,0,0,0,0,0,10,"DataOne",1,0,0,10
"pci/gm, picocuries per gram",0,0,0,0,0,0,10,"DataOne",1,0,0,10
"proportion",0,0,0,0,0,0,10,"DataOne",1,0,0,10
"qubi",0,0,0,0,0,0,10,"DataOne",1,0,0,10
"ulam",0,0,0,0,0,0,10,"DataOne",1,0,0,10
"user",0,0,0,0,0,0,10,"DataOne",1,0,0,10
"values expressed as (rounded) integer log2 of v and h in cm",0,0,0,0,0,0,10,"DataOne",1,0,0,10
"water",0,0,0,0,0,0,10,"DataOne",1,0,0,10
"footcubedpersecond",2,7,9,0,0,0,0,"EDI",1,2,7,9
"nanogramspermicroliter",0,0,0,5,7,9,0,"NEON",1,5,7,9
"microsiemenspercentimeter",1,5,9,0,0,0,0,"EDI",1,1,5,9
"permille",3,5,9,0,0,0,0,"EDI",1,3,5,9
"metersquaredperplot",1,2,9,0,0,0,0,"EDI",1,1,2,9
"micromolepersquaremeterpersecond",1,2,9,0,0,0,0,"EDI",1,1,2,9
"microsiemenspercentimeter",1,2,9,0,0,0,0,"EDI",1,1,2,9
"milligramperkilogramperday",1,2,9,0,0,0,0,"EDI",1,1,2,9
"centimeterspermeter",1,1,9,0,0,0,0,"EDI",1,1,1,9
"g/m^3",1,1,9,0,0,0,0,"EDI",1,1,1,9
"inchmercury",1,1,9,0,0,0,0,"EDI",1,1,1,9
"layer",1,1,9,0,0,0,0,"EDI",1,1,1,9
"meterpercentimeter",1,1,9,0,0,0,0,"EDI",1,1,1,9
"micromolespermolpersecond",1,1,9,0,0,0,0,"EDI",1,1,1,9
"milliequivalentsperhundredgrams",1,1,9,0,0,0,0,"EDI",1,1,1,9
"mmol/m^3",1,1,9,0,0,0,0,"EDI",1,1,1,9
"relativefluorescenceunit",1,1,9,0,0,0,0,"EDI",1,1,1,9
"footpound",0,0,0,0,0,0,9,"DataOne",1,0,0,9
"frni",0,0,0,0,0,0,9,"DataOne",1,0,0,9
"microns",0,0,0,0,0,0,9,"DataOne",1,0,0,9
"parts per billion (ppb)",0,0,0,0,0,0,9,"DataOne",1,0,0,9
"prvi",0,0,0,0,0,0,9,"DataOne",1,0,0,9
"qual",0,0,0,0,0,0,9,"DataOne",1,0,0,9
"reciprocalmeterspersteradian",0,0,0,0,0,0,9,"DataOne",1,0,0,9
"semi-quantitative stream habitat measure based on rank score from 0-15",0,0,0,0,0,0,9,"DataOne",1,0,0,9
"string",0,0,0,0,0,0,9,"DataOne",1,0,0,9
"#/kg dry soil",1,8,8,0,0,0,0,"EDI",1,1,8,8
"centimeterperhour",4,7,8,0,0,0,0,"EDI",1,4,7,8
"centimetercubedpercentimetercubed",3,5,8,0,0,0,0,"EDI",1,3,5,8
"microgramperkilogramperhour",2,5,8,0,0,0,0,"EDI",1,2,5,8
"decimaldegrees",1,4,8,0,0,0,0,"EDI",1,1,4,8
"longitude",1,4,8,0,0,0,0,"EDI",1,1,4,8
"microgramspermetersquaredperday",3,4,8,0,0,0,0,"EDI",1,3,4,8
"micromolepermetersquared",4,4,8,0,0,0,0,"EDI",1,4,4,8
"millisiemenpercentimeter",1,4,8,0,0,0,0,"EDI",1,1,4,8
"nephelometricturbidityunits",1,4,8,0,0,0,0,"EDI",1,1,4,8
"microseimenspercentimeter",1,3,8,0,0,0,0,"EDI",1,1,3,8
"milligrampermilliliter",2,3,8,0,0,0,0,"EDI",1,2,3,8
"unit unknown or not reported",1,3,8,0,0,0,0,"EDI",1,1,3,8
"microatmospheres",1,2,8,0,0,0,0,"EDI",1,1,2,8
"micromols/s/m^2",1,2,8,0,0,0,0,"EDI",1,1,2,8
"numberpermicroliter",2,2,8,0,0,0,0,"EDI",1,2,2,8
"odu",1,2,8,0,0,0,0,"EDI",1,1,2,8
"torr",1,2,8,0,0,0,0,"EDI",1,1,2,8
"#/liter",1,1,8,0,0,0,0,"EDI",1,1,1,8
"µg / ml",1,1,8,0,0,0,0,"EDI",1,1,1,8
"becquerelpermilliliter",1,1,8,0,0,0,0,"EDI",1,1,1,8
"grampergrampermetersquared",1,1,8,0,0,0,0,"EDI",1,1,1,8
"gramspersquaremeterperday",1,1,8,0,0,0,0,"EDI",1,1,1,8
"integer ",1,1,8,0,0,0,0,"EDI",1,1,1,8
"mg / 300 sq m",1,1,8,0,0,0,0,"EDI",1,1,1,8
"microequivalent per liter",1,1,8,0,0,0,0,"EDI",1,1,1,8
"microgrampermetercubed",1,1,8,0,0,0,0,"EDI",1,1,1,8
"micromoleperkilogramperhour",1,1,8,0,0,0,0,"EDI",1,1,1,8
"nanomolepermicrogramperhour",1,1,8,0,0,0,0,"EDI",1,1,1,8
"permil (‰)",1,1,8,0,0,0,0,"EDI",1,1,1,8
"unitless (normalized)",1,1,8,0,0,0,0,"EDI",1,1,1,8
"wattspermetersquare",1,1,8,0,0,0,0,"EDI",1,1,1,8
"#/km2",0,0,0,0,0,0,8,"DataOne",1,0,0,8
"100",0,0,0,0,0,0,8,"DataOne",1,0,0,8
"2008",0,0,0,0,0,0,8,"DataOne",1,0,0,8
"501",0,0,0,0,0,0,8,"DataOne",1,0,0,8
"502",0,0,0,0,0,0,8,"DataOne",1,0,0,8
"503",0,0,0,0,0,0,8,"DataOne",1,0,0,8
"505",0,0,0,0,0,0,8,"DataOne",1,0,0,8
"506",0,0,0,0,0,0,8,"DataOne",1,0,0,8
"507",0,0,0,0,0,0,8,"DataOne",1,0,0,8
"8016",0,0,0,0,0,0,8,"DataOne",1,0,0,8
"acne2",0,0,0,0,0,0,8,"DataOne",1,0,0,8
"alph98020",0,0,0,0,0,0,8,"DataOne",1,0,0,8
"date (mm/dd/yyyy)",0,0,0,0,0,0,8,"DataOne",1,0,0,8
"duty cycle 15%",0,0,0,0,0,0,8,"DataOne",1,0,0,8
"eggs per square meter",0,0,0,0,0,0,8,"DataOne",1,0,0,8
"element weight percent",0,0,0,0,0,0,8,"DataOne",1,0,0,8
"endv00013",0,0,0,0,0,0,8,"DataOne",1,0,0,8
"fall",0,0,0,0,0,0,8,"DataOne",1,0,0,8
"frequency 40hz",0,0,0,0,0,0,8,"DataOne",1,0,0,8
"i",0,0,0,0,0,0,8,"DataOne",1,0,0,8
"kilogramspersquaremeterperday",0,0,0,0,0,0,8,"DataOne",1,0,0,8
"l",0,0,0,0,0,0,8,"DataOne",1,0,0,8
"microsatellite allele scores (i.e. the length of the gene sequence in base pairs) for each locus across all samples (? indicates missing data)",0,0,0,0,0,0,8,"DataOne",1,0,0,8
"mm/dd/yyyy hh:mm:ss",0,0,0,0,0,0,8,"DataOne",1,0,0,8
"nad83",0,0,0,0,0,0,8,"DataOne",1,0,0,8
"ocns9906",0,0,0,0,0,0,8,"DataOne",1,0,0,8
"parts per billion",0,0,0,0,0,0,8,"DataOne",1,0,0,8
"quma2",0,0,0,0,0,0,8,"DataOne",1,0,0,8
"quve",0,0,0,0,0,0,8,"DataOne",1,0,0,8
"seax96004",0,0,0,0,0,0,8,"DataOne",1,0,0,8
"sievert",0,0,0,0,0,0,8,"DataOne",1,0,0,8
"square kilometers",0,0,0,0,0,0,8,"DataOne",1,0,0,8
"station",0,0,0,0,0,0,8,"DataOne",1,0,0,8
"unit not found in metadata",0,0,0,0,0,0,8,"DataOne",1,0,0,8
"van veen grab",0,0,0,0,0,0,8,"DataOne",1,0,0,8
"variable depending on spectrometer measurement type and instrument as described in the abstract",0,0,0,0,0,0,8,"DataOne",1,0,0,8
"nephelometricturbidityunits",2,6,7,0,0,0,0,"EDI",1,2,6,7
"micro siemens per centimeter",1,4,7,0,0,0,0,"EDI",1,1,4,7
"0",2,4,7,0,0,0,0,"EDI",1,2,4,7
"index",2,3,7,0,0,0,0,"EDI",1,2,3,7
"latitude",1,3,7,0,0,0,0,"EDI",1,1,3,7
"metersquaredperkilogram",2,3,7,0,0,0,0,"EDI",1,2,3,7
"microgram/g soil",1,3,7,0,0,0,0,"EDI",1,1,3,7
"psig",1,3,7,0,0,0,0,"EDI",1,1,3,7
"deg c",1,2,7,0,0,0,0,"EDI",1,1,2,7
"gc/m2",1,2,7,0,0,0,0,"EDI",1,1,2,7
"grams per milliliter",1,2,7,0,0,0,0,"EDI",1,1,2,7
"individuals",1,2,7,0,0,0,0,"EDI",1,1,2,7
"micromolepercentimetercubed",1,2,7,0,0,0,0,"EDI",1,1,2,7
"count or percent",1,1,7,0,0,0,0,"EDI",1,1,1,7
"cubicmeterperday",1,1,7,0,0,0,0,"EDI",1,1,1,7
"cubicmeterpermonth",1,1,7,0,0,0,0,"EDI",1,1,1,7
"identifier",1,1,7,0,0,0,0,"EDI",1,1,1,7
"kelvinmeterpersecond",1,1,7,0,0,0,0,"EDI",1,1,1,7
"kelvinsquared",1,1,7,0,0,0,0,"EDI",1,1,1,7
"litersperday",1,1,7,0,0,0,0,"EDI",1,1,1,7
"micrograms adsorbed per 10 cm square membrane per 1 week exposure",1,1,7,0,0,0,0,"EDI",1,1,1,7
"micrograms per 10 sqare cm per week",1,1,7,0,0,0,0,"EDI",1,1,1,7
"millimolepermolepermetersquaredpersecond",1,1,7,0,0,0,0,"EDI",1,1,1,7
"millimolesquaredpermolesquared",1,1,7,0,0,0,0,"EDI",1,1,1,7
"nanomolepermilligramperhour",1,1,7,0,0,0,0,"EDI",1,1,1,7
"numberseedequivalentspercubiccentimeter",1,1,7,0,0,0,0,"EDI",1,1,1,7
"torrsquared",1,1,7,0,0,0,0,"EDI",1,1,1,7
"ugpergram",1,1,7,0,0,0,0,"EDI",1,1,1,7
"1, 9",0,0,0,0,0,0,7,"DataOne",1,0,0,7
"2011",0,0,0,0,0,0,7,"DataOne",1,0,0,7
"2012",0,0,0,0,0,0,7,"DataOne",1,0,0,7
"calendar year",0,0,0,0,0,0,7,"DataOne",1,0,0,7
"cpue",0,0,0,0,0,0,7,"DataOne",1,0,0,7
"cubic feet per second (cfs)",0,0,0,0,0,0,7,"DataOne",1,0,0,7
"decadal",0,0,0,0,0,0,7,"DataOne",1,0,0,7
"degrees north",0,0,0,0,0,0,7,"DataOne",1,0,0,7
"dimensionless integers",0,0,0,0,0,0,7,"DataOne",1,0,0,7
"grams dry weight",0,0,0,0,0,0,7,"DataOne",1,0,0,7
"grams.",0,0,0,0,0,0,7,"DataOne",1,0,0,7
"initial",0,0,0,0,0,0,7,"DataOne",1,0,0,7
"kmcmullen",0,0,0,0,0,0,7,"DataOne",1,0,0,7
"low",0,0,0,0,0,0,7,"DataOne",1,0,0,7
"meters (m)",0,0,0,0,0,0,7,"DataOne",1,0,0,7
"milespersecond",0,0,0,0,0,0,7,"DataOne",1,0,0,7
"milliequivalentper100gram",0,0,0,0,0,0,7,"DataOne",1,0,0,7
"milligrams per liter as nitrogen (mg/l as n)",0,0,0,0,0,0,7,"DataOne",1,0,0,7
"month/day/year in the format mm/dd/yyyy",0,0,0,0,0,0,7,"DataOne",1,0,0,7
"no data value (-9999)",0,0,0,0,0,0,7,"DataOne",1,0,0,7
"ohm-meters",0,0,0,0,0,0,7,"DataOne",1,0,0,7
"parts per billion in concentration",0,0,0,0,0,0,7,"DataOne",1,0,0,7
"positive numbers, nodata = blank",0,0,0,0,0,0,7,"DataOne",1,0,0,7
"post",0,0,0,0,0,0,7,"DataOne",1,0,0,7
"pre",0,0,0,0,0,0,7,"DataOne",1,0,0,7
"relative fluoroescence units",0,0,0,0,0,0,7,"DataOne",1,0,0,7
"saa grid",0,0,0,0,0,0,7,"DataOne",1,0,0,7
"saa tap",0,0,0,0,0,0,7,"DataOne",1,0,0,7
"sand waves",0,0,0,0,0,0,7,"DataOne",1,0,0,7
"savannah",0,0,0,0,0,0,7,"DataOne",1,0,0,7
"summer",0,0,0,0,0,0,7,"DataOne",1,0,0,7
"triennial",0,0,0,0,0,0,7,"DataOne",1,0,0,7
"triennial 2",0,0,0,0,0,0,7,"DataOne",1,0,0,7
"water",0,0,0,0,0,0,7,"DataOne",1,0,0,7
"winter",0,0,0,0,0,0,7,"DataOne",1,0,0,7
"years before present",0,0,0,0,0,0,7,"DataOne",1,0,0,7
"milliequivalentperliter",3,6,6,0,0,0,0,"EDI",1,3,6,6
"yyyy-mm-dd",1,6,6,0,0,0,0,"EDI",1,1,6,6
"centimeterperday",2,5,6,0,0,0,0,"EDI",1,2,5,6
"microsiemens",4,5,6,0,0,0,0,"EDI",1,4,5,6
"micromolespersecondpersquaremeter",2,4,6,0,0,0,0,"EDI",1,2,4,6
"kilogramperyear",3,3,6,0,0,0,0,"EDI",1,3,3,6
"liters per second",1,3,6,0,0,0,0,"EDI",1,1,3,6
"microequivalentsper100g",1,3,6,0,0,0,0,"EDI",1,1,3,6
"millimeterperminute",3,3,6,0,0,0,0,"EDI",1,3,3,6
"numberpernanogram",0,0,0,2,3,6,0,"NEON",1,2,3,6
"deltaunits",1,2,6,0,0,0,0,"EDI",1,1,2,6
"microgramsper10cm2",1,2,6,0,0,0,0,"EDI",1,1,2,6
"micromols/sec/m^2",1,2,6,0,0,0,0,"EDI",1,1,2,6
"partspermil",2,2,6,0,0,0,0,"EDI",1,2,2,6
"person per km2",1,2,6,0,0,0,0,"EDI",1,1,2,6
"relative fluorescence units",1,2,6,0,0,0,0,"EDI",1,1,2,6
"trees/m^2",1,2,6,0,0,0,0,"EDI",1,1,2,6
"centemeters",1,1,6,0,0,0,0,"EDI",1,1,1,6
"cm amsl",1,1,6,0,0,0,0,"EDI",1,1,1,6
"copies/l",1,1,6,0,0,0,0,"EDI",1,1,1,6
"countperquadrat",1,1,6,0,0,0,0,"EDI",1,1,1,6
"cubicmeterpersquaremeterperday",1,1,6,0,0,0,0,"EDI",1,1,1,6
"decayperminute",1,1,6,0,0,0,0,"EDI",1,1,1,6
"degrees fahrenheit",1,1,6,0,0,0,0,"EDI",1,1,1,6
"gramspergramperhour",1,1,6,0,0,0,0,"EDI",1,1,1,6
"individuals/m2",1,1,6,0,0,0,0,"EDI",1,1,1,6
"kilogrampersecondpermegapascal",1,1,6,0,0,0,0,"EDI",1,1,1,6
"log response ratio",1,1,6,0,0,0,0,"EDI",1,1,1,6
"m/d",1,1,6,0,0,0,0,"EDI",1,1,1,6
"m^2/s^2",1,1,6,0,0,0,0,"EDI",1,1,1,6
"meter/meter",1,1,6,0,0,0,0,"EDI",1,1,1,6
"microgramc-co2pergramdrysoilperhour",1,1,6,0,0,0,0,"EDI",1,1,1,6
"microgramperkilogramperday",1,1,6,0,0,0,0,"EDI",1,1,1,6
"microgramsper10centimetersquaredperburiallength",1,1,6,0,0,0,0,"EDI",1,1,1,6
"micromoleperhourpergramdrysoil",1,1,6,0,0,0,0,"EDI",1,1,1,6
"micromolesperhectare",1,1,6,0,0,0,0,"EDI",1,1,1,6
"microsiemenspercentimetersquared",0,0,0,1,1,6,0,"NEON",1,1,1,6
"microwattpercentimetersquaredpernanometer",1,1,6,0,0,0,0,"EDI",1,1,1,6
"milligramperliterpersecond",1,1,6,0,0,0,0,"EDI",1,1,1,6
"millimetersquaredpermilligram",1,1,6,0,0,0,0,"EDI",1,1,1,6
"mmol/m^2",1,1,6,0,0,0,0,"EDI",1,1,1,6
"nanomoleperhour",1,1,6,0,0,0,0,"EDI",1,1,1,6
"no units ",1,1,6,0,0,0,0,"EDI",1,1,1,6
"numberperliiter",1,1,6,0,0,0,0,"EDI",1,1,1,6
"numberperonetenthmetersquared",1,1,6,0,0,0,0,"EDI",1,1,1,6
"quininesulfateunit",0,0,0,1,1,6,0,"NEON",1,1,1,6
"--",0,0,0,0,0,0,6,"DataOne",1,0,0,6
"13",0,0,0,0,0,0,6,"DataOne",1,0,0,6
"15",0,0,0,0,0,0,6,"DataOne",1,0,0,6
"2013",0,0,0,0,0,0,6,"DataOne",1,0,0,6
"7011",0,0,0,0,0,0,6,"DataOne",1,0,0,6
"â€°",0,0,0,0,0,0,6,"DataOne",1,0,0,6
"angling, regulated bear-viewing, unregulated bear-viewing, bear hunting, other hunting, hiking, off-trail hiking, camping, photography, helicopters, snow machining, fixed-winged aircraft, atv use",0,0,0,0,0,0,6,"DataOne",1,0,0,6
"b",0,0,0,0,0,0,6,"DataOne",1,0,0,6
"ccstp/g",0,0,0,0,0,0,6,"DataOne",1,0,0,6
"chain bag+pipe dredge",0,0,0,0,0,0,6,"DataOne",1,0,0,6
"chain bag+sm pipe dredge",0,0,0,0,0,0,6,"DataOne",1,0,0,6
"csmr",0,0,0,0,0,0,6,"DataOne",1,0,0,6
"cubicmicrometer",0,0,0,0,0,0,6,"DataOne",1,0,0,6
"datum is nad83",0,0,0,0,0,0,6,"DataOne",1,0,0,6
"delta.",0,0,0,0,0,0,6,"DataOne",1,0,0,6
"deposition",0,0,0,0,0,0,6,"DataOne",1,0,0,6
"e, c, i",0,0,0,0,0,0,6,"DataOne",1,0,0,6
"g/dl",0,0,0,0,0,0,6,"DataOne",1,0,0,6
"grad",0,0,0,0,0,0,6,"DataOne",1,0,0,6
"grams (g)",0,0,0,0,0,0,6,"DataOne",1,0,0,6
"high",0,0,0,0,0,0,6,"DataOne",1,0,0,6
"horsepower",0,0,0,0,0,0,6,"DataOne",1,0,0,6
"january",0,0,0,0,0,0,6,"DataOne",1,0,0,6
"kilograms per cubic meter",0,0,0,0,0,0,6,"DataOne",1,0,0,6
"larson",0,0,0,0,0,0,6,"DataOne",1,0,0,6
"meters (utm zone 10n wgs 84)",0,0,0,0,0,0,6,"DataOne",1,0,0,6
"meters per second",0,0,0,0,0,0,6,"DataOne",1,0,0,6
"metre",0,0,0,0,0,0,6,"DataOne",1,0,0,6
"metric tons",0,0,0,0,0,0,6,"DataOne",1,0,0,6
"mg/dl",0,0,0,0,0,0,6,"DataOne",1,0,0,6
"micrograms per liter (âµg/l)",0,0,0,0,0,0,6,"DataOne",1,0,0,6
"milligramspersquaremeterpersecond",0,0,0,0,0,0,6,"DataOne",1,0,0,6
"millimeters (mm)",0,0,0,0,0,0,6,"DataOne",1,0,0,6
"millimolar (mm)",0,0,0,0,0,0,6,"DataOne",1,0,0,6
"milliseconds",0,0,0,0,0,0,6,"DataOne",1,0,0,6
"millisiemens per centimeter",0,0,0,0,0,0,6,"DataOne",1,0,0,6
"number of taxa",0,0,0,0,0,0,6,"DataOne",1,0,0,6
"per mil relative to vpdb",0,0,0,0,0,0,6,"DataOne",1,0,0,6
"percent by weight",0,0,0,0,0,0,6,"DataOne",1,0,0,6
"pode3",0,0,0,0,0,0,6,"DataOne",1,0,0,6
"point",0,0,0,0,0,0,6,"DataOne",1,0,0,6
"quru",0,0,0,0,0,0,6,"DataOne",1,0,0,6
"relative fluorescence units",0,0,0,0,0,0,6,"DataOne",1,0,0,6
"sand",0,0,0,0,0,0,6,"DataOne",1,0,0,6
"september",0,0,0,0,0,0,6,"DataOne",1,0,0,6
"sm",0,0,0,0,0,0,6,"DataOne",1,0,0,6
"the formula for utc follows (julianday:hour:minute:second)",0,0,0,0,0,0,6,"DataOne",1,0,0,6
"the year in which station was occupied",0,0,0,0,0,0,6,"DataOne",1,0,0,6
"u/l",0,0,0,0,0,0,6,"DataOne",1,0,0,6
"waccamaw",0,0,0,0,0,0,6,"DataOne",1,0,0,6
"chains",2,5,5,0,0,0,0,"EDI",1,2,5,5
"posterior probability",1,5,5,0,0,0,0,"EDI",1,1,5,5
"rastercell",1,5,5,0,0,0,0,"EDI",1,1,5,5
"cm2/g",2,4,5,0,0,0,0,"EDI",1,2,4,5
"gramspermetersquaredpersecond",2,3,5,0,0,0,0,"EDI",1,2,3,5
"kilogramspermetercubed",2,3,5,0,0,0,0,"EDI",1,2,3,5
"kilopascalssquared",0,0,0,3,3,5,0,"NEON",1,3,3,5
"percentsquared",0,0,0,3,3,5,0,"NEON",1,3,3,5
"decimal degree",1,2,5,0,0,0,0,"EDI",1,1,2,5
"decimals",1,2,5,0,0,0,0,"EDI",1,1,2,5
"millimoleperkilogram",2,2,5,0,0,0,0,"EDI",1,2,2,5
"percent",1,2,5,0,0,0,0,"EDI",1,1,2,5
"square meters per hectare",1,2,5,0,0,0,0,"EDI",1,1,2,5
" micro siemens /cm",1,1,5,0,0,0,0,"EDI",1,1,1,5
"# / 5-minute transect",1,1,5,0,0,0,0,"EDI",1,1,1,5
"1/cm",1,1,5,0,0,0,0,"EDI",1,1,1,5
"cmbeneathpeatsurface",1,1,5,0,0,0,0,"EDI",1,1,1,5
"decimal_time",1,1,5,0,0,0,0,"EDI",1,1,1,5
"dollars",1,1,5,0,0,0,0,"EDI",1,1,1,5
"gramperyearpermetersquared",1,1,5,0,0,0,0,"EDI",1,1,1,5
"individualsecsperday",1,1,5,0,0,0,0,"EDI",1,1,1,5
"microgrampersquaremeter",1,1,5,0,0,0,0,"EDI",1,1,1,5
"milligrampermetersquaredperminute",1,1,5,0,0,0,0,"EDI",1,1,1,5
"millimoles",1,1,5,0,0,0,0,"EDI",1,1,1,5
"nanogrampermetersquaredperhour",1,1,5,0,0,0,0,"EDI",1,1,1,5
"ucc/kg",1,1,5,0,0,0,0,"EDI",1,1,1,5
"wattsm^-2",1,1,5,0,0,0,0,"EDI",1,1,1,5
"-9999",0,0,0,0,0,0,5,"DataOne",1,0,0,5
"[data source]; [region source file]",0,0,0,0,0,0,5,"DataOne",1,0,0,5
"18",0,0,0,0,0,0,5,"DataOne",1,0,0,5
"20",0,0,0,0,0,0,5,"DataOne",1,0,0,5
"2007",0,0,0,0,0,0,5,"DataOne",1,0,0,5
"2014",0,0,0,0,0,0,5,"DataOne",1,0,0,5
"300m",0,0,0,0,0,0,5,"DataOne",1,0,0,5
"acres",0,0,0,0,0,0,5,"DataOne",1,0,0,5
"ak",0,0,0,0,0,0,5,"DataOne",1,0,0,5
"animal headcount",0,0,0,0,0,0,5,"DataOne",1,0,0,5
"april",0,0,0,0,0,0,5,"DataOne",1,0,0,5
"august",0,0,0,0,0,0,5,"DataOne",1,0,0,5
"carya",0,0,0,0,0,0,5,"DataOne",1,0,0,5
"centimeters",0,0,0,0,0,0,5,"DataOne",1,0,0,5
"cerc map",0,0,0,0,0,0,5,"DataOne",1,0,0,5
"control",0,0,0,0,0,0,5,"DataOne",1,0,0,5
"days per year",0,0,0,0,0,0,5,"DataOne",1,0,0,5
"december",0,0,0,0,0,0,5,"DataOne",1,0,0,5
"degrees longitude",0,0,0,0,0,0,5,"DataOne",1,0,0,5
"dredge",0,0,0,0,0,0,5,"DataOne",1,0,0,5
"february",0,0,0,0,0,0,5,"DataOne",1,0,0,5
"first pass",0,0,0,0,0,0,5,"DataOne",1,0,0,5
"fldep",0,0,0,0,0,0,5,"DataOne",1,0,0,5
"grab",0,0,0,0,0,0,5,"DataOne",1,0,0,5
"grab sampler",0,0,0,0,0,0,5,"DataOne",1,0,0,5
"gramspermetercube",0,0,0,0,0,0,5,"DataOne",1,0,0,5
"gramspermetercubed",0,0,0,0,0,0,5,"DataOne",1,0,0,5
"gravity core",0,0,0,0,0,0,5,"DataOne",1,0,0,5
"gravity corer",0,0,0,0,0,0,5,"DataOne",1,0,0,5
"gs",0,0,0,0,0,0,5,"DataOne",1,0,0,5
"hand sample",0,0,0,0,0,0,5,"DataOne",1,0,0,5
"individual otters",0,0,0,0,0,0,5,"DataOne",1,0,0,5
"j",0,0,0,0,0,0,5,"DataOne",1,0,0,5
"julian day",0,0,0,0,0,0,5,"DataOne",1,0,0,5
"julian day (year 2007)",0,0,0,0,0,0,5,"DataOne",1,0,0,5
"july",0,0,0,0,0,0,5,"DataOne",1,0,0,5
"june",0,0,0,0,0,0,5,"DataOne",1,0,0,5
"juvenile steelhead (rbt) 0",0,0,0,0,0,0,5,"DataOne",1,0,0,5
"katm",0,0,0,0,0,0,5,"DataOne",1,0,0,5
"known",0,0,0,0,0,0,5,"DataOne",1,0,0,5
"line number",0,0,0,0,0,0,5,"DataOne",1,0,0,5
"m3/sec",0,0,0,0,0,0,5,"DataOne",1,0,0,5
"march",0,0,0,0,0,0,5,"DataOne",1,0,0,5
"may",0,0,0,0,0,0,5,"DataOne",1,0,0,5
"mid-sized seaboss grab",0,0,0,0,0,0,5,"DataOne",1,0,0,5
"milligrams of hydrocarbon per gram of rock",0,0,0,0,0,0,5,"DataOne",1,0,0,5
"milliliterspercubicmeter",0,0,0,0,0,0,5,"DataOne",1,0,0,5
"milliliterspermetersquare",0,0,0,0,0,0,5,"DataOne",1,0,0,5
"millimeters per second",0,0,0,0,0,0,5,"DataOne",1,0,0,5
"millivolts per meter",0,0,0,0,0,0,5,"DataOne",1,0,0,5
"moderate",0,0,0,0,0,0,5,"DataOne",1,0,0,5
"moru2",0,0,0,0,0,0,5,"DataOne",1,0,0,5
"ms",0,0,0,0,0,0,5,"DataOne",1,0,0,5
"ndvi units",0,0,0,0,0,0,5,"DataOne",1,0,0,5
"ng/l",0,0,0,0,0,0,5,"DataOne",1,0,0,5
"noaa/nos",0,0,0,0,0,0,5,"DataOne",1,0,0,5
"november",0,0,0,0,0,0,5,"DataOne",1,0,0,5
"numberpercubiccentimeter",0,0,0,0,0,0,5,"DataOne",1,0,0,5
"observer andrew todd, ben mcgee",0,0,0,0,0,0,5,"DataOne",1,0,0,5
"october",0,0,0,0,0,0,5,"DataOne",1,0,0,5
"other",0,0,0,0,0,0,5,"DataOne",1,0,0,5
"per mil (0/00)",0,0,0,0,0,0,5,"DataOne",1,0,0,5
"pipe dredge",0,0,0,0,0,0,5,"DataOne",1,0,0,5
"prse2",0,0,0,0,0,0,5,"DataOne",1,0,0,5
"reference",0,0,0,0,0,0,5,"DataOne",1,0,0,5
"rocky",0,0,0,0,0,0,5,"DataOne",1,0,0,5
"sand",0,0,0,0,0,0,5,"DataOne",1,0,0,5
"sandwaves",0,0,0,0,0,0,5,"DataOne",1,0,0,5
"sani",0,0,0,0,0,0,5,"DataOne",1,0,0,5
"sg",0,0,0,0,0,0,5,"DataOne",1,0,0,5
"shots",0,0,0,0,0,0,5,"DataOne",1,0,0,5
"silty sand",0,0,0,0,0,0,5,"DataOne",1,0,0,5
"smith-macintyre grab",0,0,0,0,0,0,5,"DataOne",1,0,0,5
"stations",0,0,0,0,0,0,5,"DataOne",1,0,0,5
"t",0,0,0,0,0,0,5,"DataOne",1,0,0,5
"time in military time",0,0,0,0,0,0,5,"DataOne",1,0,0,5
"trace",0,0,0,0,0,0,5,"DataOne",1,0,0,5
"vibra core",0,0,0,0,0,0,5,"DataOne",1,0,0,5
"visual observation",0,0,0,0,0,0,5,"DataOne",1,0,0,5
"wreck",0,0,0,0,0,0,5,"DataOne",1,0,0,5
"megapixel",1,4,4,0,0,0,0,"EDI",1,1,4,4
"pixel",1,4,4,0,0,0,0,"EDI",1,1,4,4
"feetpersecond",1,3,4,0,0,0,0,"EDI",1,1,3,4
"quininesulfateunits",1,3,4,0,0,0,0,"EDI",1,1,3,4
"recruits",1,3,4,0,0,0,0,"EDI",1,1,3,4
"# individuals",1,2,4,0,0,0,0,"EDI",1,1,2,4
"cubiccentimeters",2,2,4,0,0,0,0,"EDI",1,2,2,4
"day of month",1,2,4,0,0,0,0,"EDI",1,1,2,4
"decimeters",1,2,4,0,0,0,0,"EDI",1,1,2,4
"grampercubiccentimeter",2,2,4,0,0,0,0,"EDI",1,2,2,4
"micromol co2/m2sec",2,2,4,0,0,0,0,"EDI",1,2,2,4
"micromolepermetersquaredperminute",1,2,4,0,0,0,0,"EDI",1,1,2,4
"milligramperliterperday",1,2,4,0,0,0,0,"EDI",1,1,2,4
"milligrampermilliliterperday",2,2,4,0,0,0,0,"EDI",1,2,2,4
"millimolespergram",1,2,4,0,0,0,0,"EDI",1,1,2,4
"nanomole",2,2,4,0,0,0,0,"EDI",1,2,2,4
"nanomoleperliterperday",1,2,4,0,0,0,0,"EDI",1,1,2,4
"no unit",1,2,4,0,0,0,0,"EDI",1,1,2,4
"perminute",1,2,4,0,0,0,0,"EDI",1,1,2,4
"persons per square kilometer",1,2,4,0,0,0,0,"EDI",1,1,2,4
"persons per square km",1,2,4,0,0,0,0,"EDI",1,1,2,4
"rotations per minute",1,2,4,0,0,0,0,"EDI",1,1,2,4
"waterfractionbyvolume",1,2,4,0,0,0,0,"EDI",1,1,2,4
"% dry wt.",1,1,4,0,0,0,0,"EDI",1,1,1,4
"%dw",1,1,4,0,0,0,0,"EDI",1,1,1,4
"/m2",1,1,4,0,0,0,0,"EDI",1,1,1,4
"1/m",1,1,4,0,0,0,0,"EDI",1,1,1,4
"biomass/m^2",1,1,4,0,0,0,0,"EDI",1,1,1,4
"celsiusdegree",1,1,4,0,0,0,0,"EDI",1,1,1,4
"centimeterpercubiccentimeter",1,1,4,0,0,0,0,"EDI",1,1,1,4
"cubic centimeters per cubic centimeter",1,1,4,0,0,0,0,"EDI",1,1,1,4
"cubiccentimeterpercubiccentimeter",1,1,4,0,0,0,0,"EDI",1,1,1,4
"decimaldegree",1,1,4,0,0,0,0,"EDI",1,1,1,4
"dilution factor",1,1,4,0,0,0,0,"EDI",1,1,1,4
"dollarperyear",1,1,4,0,0,0,0,"EDI",1,1,1,4
"gramo2permetersquaredperday",1,1,4,0,0,0,0,"EDI",1,1,1,4
"grampersquaremeterperday",1,1,4,0,0,0,0,"EDI",1,1,1,4
"growing degree days (degree c)",1,1,4,0,0,0,0,"EDI",1,1,1,4
"interger",1,1,4,0,0,0,0,"EDI",1,1,1,4
"kilogramperhectareperday",1,1,4,0,0,0,0,"EDI",1,1,1,4
"kilogramperkilometersquared",1,1,4,0,0,0,0,"EDI",1,1,1,4
"kilogramperpixel",1,1,4,0,0,0,0,"EDI",1,1,1,4
"kilojoule",1,1,4,0,0,0,0,"EDI",1,1,1,4
"m/v",1,1,4,0,0,0,0,"EDI",1,1,1,4
"mg p/l",1,1,4,0,0,0,0,"EDI",1,1,1,4
"micrograms/cm2",1,1,4,0,0,0,0,"EDI",1,1,1,4
"microgramsperlitter",1,1,4,0,0,0,0,"EDI",1,1,1,4
"milligrampergramdrymass",1,1,4,0,0,0,0,"EDI",1,1,1,4
"milligramspercubicdecimeter",1,1,4,0,0,0,0,"EDI",1,1,1,4
"milligramspermetersquare",1,1,4,0,0,0,0,"EDI",1,1,1,4
"millim",1,1,4,0,0,0,0,"EDI",1,1,1,4
"millimeterperhourperday",1,1,4,0,0,0,0,"EDI",1,1,1,4
"millimolepersecond",1,1,4,0,0,0,0,"EDI",1,1,1,4
"millimolspermetercubedperday",1,1,4,0,0,0,0,"EDI",1,1,1,4
"minusloghydrogenion",1,1,4,0,0,0,0,"EDI",1,1,1,4
"multiple",1,1,4,0,0,0,0,"EDI",1,1,1,4
"nanomolepergramperday",1,1,4,0,0,0,0,"EDI",1,1,1,4
"nanomolepermilliliter",1,1,4,0,0,0,0,"EDI",1,1,1,4
"permille",1,1,4,0,0,0,0,"EDI",1,1,1,4
"pings/m^3/30 min",1,1,4,0,0,0,0,"EDI",1,1,1,4
"pressure in bars",1,1,4,0,0,0,0,"EDI",1,1,1,4
"species",1,1,4,0,0,0,0,"EDI",1,1,1,4
"squarerootkilogramperhectare",1,1,4,0,0,0,0,"EDI",1,1,1,4
"stems/ha",1,1,4,0,0,0,0,"EDI",1,1,1,4
"stipes",1,1,4,0,0,0,0,"EDI",1,1,1,4
"time in military hours and minutes",1,1,4,0,0,0,0,"EDI",1,1,1,4
"time spent in fear area",1,1,4,0,0,0,0,"EDI",1,1,1,4
"time spent in safety area",1,1,4,0,0,0,0,"EDI",1,1,1,4
"ug-n/g dry soil",1,1,4,0,0,0,0,"EDI",1,1,1,4
"ugco2-c/gsoildwt/day",1,1,4,0,0,0,0,"EDI",1,1,1,4
"um n",1,1,4,0,0,0,0,"EDI",1,1,1,4
"(blank)",0,0,0,0,0,0,4,"DataOne",1,0,0,4
"~",0,0,0,0,0,0,4,"DataOne",1,0,0,4
"1 meter plankton net",0,0,0,0,0,0,4,"DataOne",1,0,0,4
"17",0,0,0,0,0,0,4,"DataOne",1,0,0,4
"2003",0,0,0,0,0,0,4,"DataOne",1,0,0,4
"2006",0,0,0,0,0,0,4,"DataOne",1,0,0,4
"2016",0,0,0,0,0,0,4,"DataOne",1,0,0,4
"207",0,0,0,0,0,0,4,"DataOne",1,0,0,4
"24",0,0,0,0,0,0,4,"DataOne",1,0,0,4
"30",0,0,0,0,0,0,4,"DataOne",1,0,0,4
"42810",0,0,0,0,0,0,4,"DataOne",1,0,0,4
"a1",0,0,0,0,0,0,4,"DataOne",1,0,0,4
"a2",0,0,0,0,0,0,4,"DataOne",1,0,0,4
"add units",0,0,0,0,0,0,4,"DataOne",1,0,0,4
"adult",0,0,0,0,0,0,4,"DataOne",1,0,0,4
"arc_degree",0,0,0,0,0,0,4,"DataOne",1,0,0,4
"autumn",0,0,0,0,0,0,4,"DataOne",1,0,0,4
"before",0,0,0,0,0,0,4,"DataOne",1,0,0,4
"box core",0,0,0,0,0,0,4,"DataOne",1,0,0,4
"bt",0,0,0,0,0,0,4,"DataOne",1,0,0,4
"c-a",0,0,0,0,0,0,4,"DataOne",1,0,0,4
"ca",0,0,0,0,0,0,4,"DataOne",1,0,0,4
"calendar dates",0,0,0,0,0,0,4,"DataOne",1,0,0,4
"cenote pool",0,0,0,0,0,0,4,"DataOne",1,0,0,4
"cgbt",0,0,0,0,0,0,4,"DataOne",1,0,0,4
"core",0,0,0,0,0,0,4,"DataOne",1,0,0,4
"cornu",0,0,0,0,0,0,4,"DataOne",1,0,0,4
"cubic cm",0,0,0,0,0,0,4,"DataOne",1,0,0,4
"cubicmicrometerpercubiccentimeter",0,0,0,0,0,0,4,"DataOne",1,0,0,4
"d1",0,0,0,0,0,0,4,"DataOne",1,0,0,4
"d2",0,0,0,0,0,0,4,"DataOne",1,0,0,4
"dec degrees seconds",0,0,0,0,0,0,4,"DataOne",1,0,0,4
"decimal minutes",0,0,0,0,0,0,4,"DataOne",1,0,0,4
"degrees",0,0,0,0,0,0,4,"DataOne",1,0,0,4
"degrees and decimal minutes",0,0,0,0,0,0,4,"DataOne",1,0,0,4
"determined",0,0,0,0,0,0,4,"DataOne",1,0,0,4
"digby dredge",0,0,0,0,0,0,4,"DataOne",1,0,0,4
"digby dredge w/ cnvs bag",0,0,0,0,0,0,4,"DataOne",1,0,0,4
"erosion",0,0,0,0,0,0,4,"DataOne",1,0,0,4
"est",0,0,0,0,0,0,4,"DataOne",1,0,0,4
"expanded",0,0,0,0,0,0,4,"DataOne",1,0,0,4
"fl",0,0,0,0,0,0,4,"DataOne",1,0,0,4
"gaar",0,0,0,0,0,0,4,"DataOne",1,0,0,4
"grams per meter squared per year (g/m2/year)",0,0,0,0,0,0,4,"DataOne",1,0,0,4
"gravelly sand",0,0,0,0,0,0,4,"DataOne",1,0,0,4
"green",0,0,0,0,0,0,4,"DataOne",1,0,0,4
"hectares",0,0,0,0,0,0,4,"DataOne",1,0,0,4
"hydrostatic core",0,0,0,0,0,0,4,"DataOne",1,0,0,4
"iku grab",0,0,0,0,0,0,4,"DataOne",1,0,0,4
"julian day is the integer number representing the interval of time in days since january 1 of the year of collection.",0,0,0,0,0,0,4,"DataOne",1,0,0,4
"k",0,0,0,0,0,0,4,"DataOne",1,0,0,4
"kilometers",0,0,0,0,0,0,4,"DataOne",1,0,0,4
"kod",0,0,0,0,0,0,4,"DataOne",1,0,0,4
"kws-1",0,0,0,0,0,0,4,"DataOne",1,0,0,4
"kws-5",0,0,0,0,0,0,4,"DataOne",1,0,0,4
"la",0,0,0,0,0,0,4,"DataOne",1,0,0,4
"lacl",0,0,0,0,0,0,4,"DataOne",1,0,0,4
"log of kilograms",0,0,0,0,0,0,4,"DataOne",1,0,0,4
"lower",0,0,0,0,0,0,4,"DataOne",1,0,0,4
"marsh",0,0,0,0,0,0,4,"DataOne",1,0,0,4
"meq/100g",0,0,0,0,0,0,4,"DataOne",1,0,0,4
"meters above mean sea level (m amsl)",0,0,0,0,0,0,4,"DataOne",1,0,0,4
"mg hc/g rock",0,0,0,0,0,0,4,"DataOne",1,0,0,4
"mg/dl.",0,0,0,0,0,0,4,"DataOne",1,0,0,4
"mg_vermiculite_compositional_table",0,0,0,0,0,0,4,"DataOne",1,0,0,4
"micrograms per liter, < indicates value was less than the laboratory reporting level",0,0,0,0,0,0,4,"DataOne",1,0,0,4
"microsiemen",0,0,0,0,0,0,4,"DataOne",1,0,0,4
"microsiemens per centimeter at 25 degrees celsius (âµs/cm at 25 â°c)",0,0,0,0,0,0,4,"DataOne",1,0,0,4
"middle",0,0,0,0,0,0,4,"DataOne",1,0,0,4
"millimeter per second",0,0,0,0,0,0,4,"DataOne",1,0,0,4
"millimeters (mm)",0,0,0,0,0,0,4,"DataOne",1,0,0,4
"millimeters multiplied by 100",0,0,0,0,0,0,4,"DataOne",1,0,0,4
"million gallons",0,0,0,0,0,0,4,"DataOne",1,0,0,4
"mm/yr",0,0,0,0,0,0,4,"DataOne",1,0,0,4
"ms",0,0,0,0,0,0,4,"DataOne",1,0,0,4
"mud",0,0,0,0,0,0,4,"DataOne",1,0,0,4
"nanogram per gram",0,0,0,0,0,0,4,"DataOne",1,0,0,4
"nanoteslas",0,0,0,0,0,0,4,"DataOne",1,0,0,4
"ne",0,0,0,0,0,0,4,"DataOne",1,0,0,4
"notes",0,0,0,0,0,0,4,"DataOne",1,0,0,4
"numberperliter",0,0,0,0,0,0,4,"DataOne",1,0,0,4
"numberperpool",0,0,0,0,0,0,4,"DataOne",1,0,0,4
"nw",0,0,0,0,0,0,4,"DataOne",1,0,0,4
"o",0,0,0,0,0,0,4,"DataOne",1,0,0,4
"off txs",0,0,0,0,0,0,4,"DataOne",1,0,0,4
"other",0,0,0,0,0,0,4,"DataOne",1,0,0,4
"p-c",0,0,0,0,0,0,4,"DataOne",1,0,0,4
"parts per million by volume",0,0,0,0,0,0,4,"DataOne",1,0,0,4
"parts per thousand",0,0,0,0,0,0,4,"DataOne",1,0,0,4
"percentage of total sample weight",0,0,0,0,0,0,4,"DataOne",1,0,0,4
"piston core",0,0,0,0,0,0,4,"DataOne",1,0,0,4
"poportionbasalarea",0,0,0,0,0,0,4,"DataOne",1,0,0,4
"practical salinity units",0,0,0,0,0,0,4,"DataOne",1,0,0,4
"proportion of time",0,0,0,0,0,0,4,"DataOne",1,0,0,4
"reflection point",0,0,0,0,0,0,4,"DataOne",1,0,0,4
"sandy silt",0,0,0,0,0,0,4,"DataOne",1,0,0,4
"sc",0,0,0,0,0,0,4,"DataOne",1,0,0,4
"sediment trap",0,0,0,0,0,0,4,"DataOne",1,0,0,4
"shipek grab",0,0,0,0,0,0,4,"DataOne",1,0,0,4
"shipwreck",0,0,0,0,0,0,4,"DataOne",1,0,0,4
"shot points",0,0,0,0,0,0,4,"DataOne",1,0,0,4
"smith-macintyre w/o camera",0,0,0,0,0,0,4,"DataOne",1,0,0,4
"sorting and reworking",0,0,0,0,0,0,4,"DataOne",1,0,0,4
"sr",0,0,0,0,0,0,4,"DataOne",1,0,0,4
"st",0,0,0,0,0,0,4,"DataOne",1,0,0,4
"submersible sample",0,0,0,0,0,0,4,"DataOne",1,0,0,4
"sw",0,0,0,0,0,0,4,"DataOne",1,0,0,4
"trigger core",0,0,0,0,0,0,4,"DataOne",1,0,0,4
"unexpanded",0,0,0,0,0,0,4,"DataOne",1,0,0,4
"unknown",0,0,0,0,0,0,4,"DataOne",1,0,0,4
"upper",0,0,0,0,0,0,4,"DataOne",1,0,0,4
"usgs nwis",0,0,0,0,0,0,4,"DataOne",1,0,0,4
"ut",0,0,0,0,0,0,4,"DataOne",1,0,0,4
"variable. measurement units for reported concentrations or activities for the constituents are provided in table01_constituents.xlsx.",0,0,0,0,0,0,4,"DataOne",1,0,0,4
"vermicuilte_ore_composition_table",0,0,0,0,0,0,4,"DataOne",1,0,0,4
"vibracore",0,0,0,0,0,0,4,"DataOne",1,0,0,4
"wa",0,0,0,0,0,0,4,"DataOne",1,0,0,4
"waypoint number",0,0,0,0,0,0,4,"DataOne",1,0,0,4
"wet meadow",0,0,0,0,0,0,4,"DataOne",1,0,0,4
"wm",0,0,0,0,0,0,4,"DataOne",1,0,0,4
"yes or no.",0,0,0,0,0,0,4,"DataOne",1,0,0,4
"hitspersquarecentimeter",1,3,3,0,0,0,0,"EDI",1,1,3,3
"meterpermeter",3,3,3,0,0,0,0,"EDI",1,3,3,3
"micromolepergrampersecond",2,3,3,0,0,0,0,"EDI",1,2,3,3
"milligrampercentimetersquaredperday",1,3,3,0,0,0,0,"EDI",1,1,3,3
"millimeterpermegapascalperhour",1,3,3,0,0,0,0,"EDI",1,1,3,3
"24-hourtime",1,2,3,0,0,0,0,"EDI",1,1,2,3
"drought index ",1,2,3,0,0,0,0,"EDI",1,1,2,3
"grampercentimetersquared",1,2,3,0,0,0,0,"EDI",1,1,2,3
"index",2,2,3,0,0,0,0,"EDI",1,2,2,3
"inversecentimeter",1,2,3,0,0,0,0,"EDI",1,1,2,3
"kilogramperday",2,2,3,0,0,0,0,"EDI",1,2,2,3
"lumen/foot2",1,2,3,0,0,0,0,"EDI",1,1,2,3
"megajoulepermetersquared",2,2,3,0,0,0,0,"EDI",1,2,2,3
"microgrampersquaremeter",2,2,3,0,0,0,0,"EDI",1,2,2,3
"millimolespermetersquaredpersecond",2,2,3,0,0,0,0,"EDI",1,2,2,3
"molepermole",1,2,3,0,0,0,0,"EDI",1,1,2,3
"no unit",1,2,3,0,0,0,0,"EDI",1,1,2,3
"number of minutes of time",1,2,3,0,0,0,0,"EDI",1,1,2,3
"ohms-cm",1,2,3,0,0,0,0,"EDI",1,1,2,3
"peryear",1,2,3,0,0,0,0,"EDI",1,1,2,3
"platinumcobaltunits",1,2,3,0,0,0,0,"EDI",1,1,2,3
"poundperacre",2,2,3,0,0,0,0,"EDI",1,2,2,3
"
                milligrampercentimetersquared",1,1,3,0,0,0,0,"EDI",1,1,1,3
"(null",1,1,3,0,0,0,0,"EDI",1,1,1,3
"0to1",1,1,3,0,0,0,0,"EDI",1,1,1,3
"annualdmaridityindex",1,1,3,0,0,0,0,"EDI",1,1,1,3
"binary",1,1,3,0,0,0,0,"EDI",1,1,1,3
"cm^2/m^2",1,1,3,0,0,0,0,"EDI",1,1,1,3
"coloniesper100milliliter",1,1,3,0,0,0,0,"EDI",1,1,1,3
"count of fish individuals",1,1,3,0,0,0,0,"EDI",1,1,1,3
"countsper6meterssquared",1,1,3,0,0,0,0,"EDI",1,1,1,3
"day-1",1,1,3,0,0,0,0,"EDI",1,1,1,3
"dollarpermetricton",1,1,3,0,0,0,0,"EDI",1,1,1,3
"fishperenclosure",1,1,3,0,0,0,0,"EDI",1,1,1,3
"gcm-230mins",1,1,3,0,0,0,0,"EDI",1,1,1,3
"grams oxygen per square meter per day ",1,1,3,0,0,0,0,"EDI",1,1,1,3
"gramsofoyxgenpersquaremeterperday",1,1,3,0,0,0,0,"EDI",1,1,1,3
"gramspersquaremeter ",1,1,3,0,0,0,0,"EDI",1,1,1,3
"gravitationalforce",1,1,3,0,0,0,0,"EDI",1,1,1,3
"inchesperhourtimeshundred",1,1,3,0,0,0,0,"EDI",1,1,1,3
"individualscounted",1,1,3,0,0,0,0,"EDI",1,1,1,3
"j/m^3/k",1,1,3,0,0,0,0,"EDI",1,1,1,3
"kg/m^2/s",1,1,3,0,0,0,0,"EDI",1,1,1,3
"kg/m2/s",1,1,3,0,0,0,0,"EDI",1,1,1,3
"kilogrampersquarekilometer",1,1,3,0,0,0,0,"EDI",1,1,1,3
"kilowatthourspermetersquareperday",1,1,3,0,0,0,0,"EDI",1,1,1,3
"km^2",1,1,3,0,0,0,0,"EDI",1,1,1,3
"log(10) viable seed count per trap",1,1,3,0,0,0,0,"EDI",1,1,1,3
"metercelsiuspersecond",1,1,3,0,0,0,0,"EDI",1,1,1,3
"metersquaredperhundredmetersquared",1,1,3,0,0,0,0,"EDI",1,1,1,3
"mg n/l",1,1,3,0,0,0,0,"EDI",1,1,1,3
"mgn/kgdrysoil*d",1,1,3,0,0,0,0,"EDI",1,1,1,3
"mgn/l",1,1,3,0,0,0,0,"EDI",1,1,1,3
"mgrampermetersquared",1,1,3,0,0,0,0,"EDI",1,1,1,3
"microgrampermilligram",1,1,3,0,0,0,0,"EDI",1,1,1,3
"microgrampermilliliterperday",1,1,3,0,0,0,0,"EDI",1,1,1,3
"microgrampermillimetersquared",1,1,3,0,0,0,0,"EDI",1,1,1,3
"micrograms per gram per day",1,1,3,0,0,0,0,"EDI",1,1,1,3
"microgramsdoppermeter",1,1,3,0,0,0,0,"EDI",1,1,1,3
"microgramsdoppermilligramsdoc",1,1,3,0,0,0,0,"EDI",1,1,1,3
"microgramspercubicmeter",1,1,3,0,0,0,0,"EDI",1,1,1,3
"microgramstppermeter",1,1,3,0,0,0,0,"EDI",1,1,1,3
"microgramstppermilligramsdoc",1,1,3,0,0,0,0,"EDI",1,1,1,3
"micromolespersecondpermetersquared",1,1,3,0,0,0,0,"EDI",1,1,1,3
"micromolespersquaremeter",1,1,3,0,0,0,0,"EDI",1,1,1,3
"micromolespersquaremeterperday",1,1,3,0,0,0,0,"EDI",1,1,1,3
"micromolperliterperhour ",1,1,3,0,0,0,0,"EDI",1,1,1,3
"microsiemenspercm",1,1,3,0,0,0,0,"EDI",1,1,1,3
"millibars",1,1,3,0,0,0,0,"EDI",1,1,1,3
"milliequivalentper100gram",1,1,3,0,0,0,0,"EDI",1,1,1,3
"milligauss",1,1,3,0,0,0,0,"EDI",1,1,1,3
"milligrampergrampertwodays",1,1,3,0,0,0,0,"EDI",1,1,1,3
"milligramperliterasnitrogen",1,1,3,0,0,0,0,"EDI",1,1,1,3
"milligrams of oxygen per liter per day",1,1,3,0,0,0,0,"EDI",1,1,1,3
"milligramstnpermeter",1,1,3,0,0,0,0,"EDI",1,1,1,3
"milligramstnpermilligramsdoc",1,1,3,0,0,0,0,"EDI",1,1,1,3
"millimeterpersecond",1,1,3,0,0,0,0,"EDI",1,1,1,3
"millimolescarbonpersquaremeterperday",1,1,3,0,0,0,0,"EDI",1,1,1,3
"millimolespercubicmeterperday",1,1,3,0,0,0,0,"EDI",1,1,1,3
"millimolpersecondpersquaremeter",1,1,3,0,0,0,0,"EDI",1,1,1,3
"millimolspersecondpersquaremeter",1,1,3,0,0,0,0,"EDI",1,1,1,3
"minimalerythemadose",1,1,3,0,0,0,0,"EDI",1,1,1,3
"minuslogactivity",1,1,3,0,0,0,0,"EDI",1,1,1,3
"molepermetersquaredpersecond",1,1,3,0,0,0,0,"EDI",1,1,1,3
"nanogramspermilliliter",1,1,3,0,0,0,0,"EDI",1,1,1,3
"per mil vpdb",1,1,3,0,0,0,0,"EDI",1,1,1,3
"perday",1,1,3,0,0,0,0,"EDI",1,1,1,3
"permil",1,1,3,0,0,0,0,"EDI",1,1,1,3
"practical salinity unit",1,1,3,0,0,0,0,"EDI",1,1,1,3
"reflectiveflorescenceunits",1,1,3,0,0,0,0,"EDI",1,1,1,3
"relativeflourescenceunit",1,1,3,0,0,0,0,"EDI",1,1,1,3
"seedlings",1,1,3,0,0,0,0,"EDI",1,1,1,3
"seedlings/m2",1,1,3,0,0,0,0,"EDI",1,1,1,3
"spad",1,1,3,0,0,0,0,"EDI",1,1,1,3
"squaremeterperhectare",1,1,3,0,0,0,0,"EDI",1,1,1,3
"stretched grayscale spectral brightness",1,1,3,0,0,0,0,"EDI",1,1,1,3
"ug n g-1 day-1",1,1,3,0,0,0,0,"EDI",1,1,1,3
"ugco2-c/gsoildwt",1,1,3,0,0,0,0,"EDI",1,1,1,3
"ugnutrient/gramdryresin",1,1,3,0,0,0,0,"EDI",1,1,1,3
"umolsubstrate/gc/hr",1,1,3,0,0,0,0,"EDI",1,1,1,3
"umolsubstrate/gsoil/hr",1,1,3,0,0,0,0,"EDI",1,1,1,3
"unique id",1,1,3,0,0,0,0,"EDI",1,1,1,3
"unitless - ratio",1,1,3,0,0,0,0,"EDI",1,1,1,3
"viable seed count per trap",1,1,3,0,0,0,0,"EDI",1,1,1,3
"voltmeterssquaredperwatt",0,0,0,1,1,3,0,"NEON",1,1,1,3
"wattperm-2",1,1,3,0,0,0,0,"EDI",1,1,1,3
"wattspersquaremeterpersteradianpermicrometer",1,1,3,0,0,0,0,"EDI",1,1,1,3
"""north america"",  ""central america and the caribbean"",  ""south america"",  ""eastern australia"",  ""southeast asia archipelagos"",  ""central  and eastern asia"",  ""northeast asia"",  ""southeast asia"", ""middle east"", ""europe""",0,0,0,0,0,0,3,"DataOne",1,0,0,3
"(per mil)",0,0,0,0,0,0,3,"DataOne",1,0,0,3
"*",0,0,0,0,0,0,3,"DataOne",1,0,0,3
">",0,0,0,0,0,0,3,"DataOne",1,0,0,3
"0",0,0,0,0,0,0,3,"DataOne",1,0,0,3
"0.001",0,0,0,0,0,0,3,"DataOne",1,0,0,3
"1-meter dredge",0,0,0,0,0,0,3,"DataOne",1,0,0,3
"14",0,0,0,0,0,0,3,"DataOne",1,0,0,3
"16",0,0,0,0,0,0,3,"DataOne",1,0,0,3
"19",0,0,0,0,0,0,3,"DataOne",1,0,0,3
"2002",0,0,0,0,0,0,3,"DataOne",1,0,0,3
"2011-006-fa",0,0,0,0,0,0,3,"DataOne",1,0,0,3
"2012-002-fa",0,0,0,0,0,0,3,"DataOne",1,0,0,3
"2013-005-fa",0,0,0,0,0,0,3,"DataOne",1,0,0,3
"24 hour day, represented as julian number",0,0,0,0,0,0,3,"DataOne",1,0,0,3
"35mm stereo camera+dred",0,0,0,0,0,0,3,"DataOne",1,0,0,3
"50",0,0,0,0,0,0,3,"DataOne",1,0,0,3
"51",0,0,0,0,0,0,3,"DataOne",1,0,0,3
"600",0,0,0,0,0,0,3,"DataOne",1,0,0,3
"630",0,0,0,0,0,0,3,"DataOne",1,0,0,3
"631",0,0,0,0,0,0,3,"DataOne",1,0,0,3
"665",0,0,0,0,0,0,3,"DataOne",1,0,0,3
"671",0,0,0,0,0,0,3,"DataOne",1,0,0,3
"80154",0,0,0,0,0,0,3,"DataOne",1,0,0,3
"a",0,0,0,0,0,0,3,"DataOne",1,0,0,3
"âµgg-1",0,0,0,0,0,0,3,"DataOne",1,0,0,3
"aerial photographs",0,0,0,0,0,0,3,"DataOne",1,0,0,3
"ahy",0,0,0,0,0,0,3,"DataOne",1,0,0,3
"airstrip drain/standing h2o",0,0,0,0,0,0,3,"DataOne",1,0,0,3
"al",0,0,0,0,0,0,3,"DataOne",1,0,0,3
"anby",0,0,0,0,0,0,3,"DataOne",1,0,0,3
"anchor flukes",0,0,0,0,0,0,3,"DataOne",1,0,0,3
"anchor sample",0,0,0,0,0,0,3,"DataOne",1,0,0,3
"arctic grayling",0,0,0,0,0,0,3,"DataOne",1,0,0,3
"are log base 2 of â€œwnv plaque reduction assay titerâ€.",0,0,0,0,0,0,3,"DataOne",1,0,0,3
"asterias",0,0,0,0,0,0,3,"DataOne",1,0,0,3
"asy",0,0,0,0,0,0,3,"DataOne",1,0,0,3
"aybn",0,0,0,0,0,0,3,"DataOne",1,0,0,3
"bedrock",0,0,0,0,0,0,3,"DataOne",1,0,0,3
"best",0,0,0,0,0,0,3,"DataOne",1,0,0,3
"blake trawl",0,0,0,0,0,0,3,"DataOne",1,0,0,3
"boomerang corer",0,0,0,0,0,0,3,"DataOne",1,0,0,3
"bot drifter salinometer",0,0,0,0,0,0,3,"DataOne",1,0,0,3
"bottom drifter",0,0,0,0,0,0,3,"DataOne",1,0,0,3
"bottom drifter bug",0,0,0,0,0,0,3,"DataOne",1,0,0,3
"bottom skimmer",0,0,0,0,0,0,3,"DataOne",1,0,0,3
"boulder ridges <1 meter in height",0,0,0,0,0,0,3,"DataOne",1,0,0,3
"boulder ridges >=1 meter in height",0,0,0,0,0,0,3,"DataOne",1,0,0,3
"boulders",0,0,0,0,0,0,3,"DataOne",1,0,0,3
"box sampler",0,0,0,0,0,0,3,"DataOne",1,0,0,3
"building",0,0,0,0,0,0,3,"DataOne",1,0,0,3
"bunker hill",0,0,0,0,0,0,3,"DataOne",1,0,0,3
"c",0,0,0,0,0,0,3,"DataOne",1,0,0,3
"cam grab w/o cam+plank t",0,0,0,0,0,0,3,"DataOne",1,0,0,3
"camera sled",0,0,0,0,0,0,3,"DataOne",1,0,0,3
"campbell grab w/ camera",0,0,0,0,0,0,3,"DataOne",1,0,0,3
"campbell grab w/o camera",0,0,0,0,0,0,3,"DataOne",1,0,0,3
"cc/g of water at standard temperature and pressure times 109",0,0,0,0,0,0,3,"DataOne",1,0,0,3
"celcius",0,0,0,0,0,0,3,"DataOne",1,0,0,3
"cellsperliter",0,0,0,0,0,0,3,"DataOne",1,0,0,3
"chain bag",0,0,0,0,0,0,3,"DataOne",1,0,0,3
"chain bag dredge",0,0,0,0,0,0,3,"DataOne",1,0,0,3
"chain bag+pipe",0,0,0,0,0,0,3,"DataOne",1,0,0,3
"chain bag+sm pipe",0,0,0,0,0,0,3,"DataOne",1,0,0,3
"chain dredge",0,0,0,0,0,0,3,"DataOne",1,0,0,3
"clayey silt",0,0,0,0,0,0,3,"DataOne",1,0,0,3
"coarse sand",0,0,0,0,0,0,3,"DataOne",1,0,0,3
"coarse silt",0,0,0,0,0,0,3,"DataOne",1,0,0,3
"cobble",0,0,0,0,0,0,3,"DataOne",1,0,0,3
"coffee dome",0,0,0,0,0,0,3,"DataOne",1,0,0,3
"corallimorph",0,0,0,0,0,0,3,"DataOne",1,0,0,3
"coring tube in mech arm",0,0,0,0,0,0,3,"DataOne",1,0,0,3
"cps, counts per second",0,0,0,0,0,0,3,"DataOne",1,0,0,3
"ct",0,0,0,0,0,0,3,"DataOne",1,0,0,3
"ctd",0,0,0,0,0,0,3,"DataOne",1,0,0,3
"d-l snapper",0,0,0,0,0,0,3,"DataOne",1,0,0,3
"d-l snapper + dredge",0,0,0,0,0,0,3,"DataOne",1,0,0,3
"d-l snapper + grav cor",0,0,0,0,0,0,3,"DataOne",1,0,0,3
"date (month/day/year)",0,0,0,0,0,0,3,"DataOne",1,0,0,3
"date (yyyy-mm-dd)",0,0,0,0,0,0,3,"DataOne",1,0,0,3
"day of visit, numbered with may 22 = 1",0,0,0,0,0,0,3,"DataOne",1,0,0,3
"decimal degrees north",0,0,0,0,0,0,3,"DataOne",1,0,0,3
"decisiemenpermetre",0,0,0,0,0,0,3,"DataOne",1,0,0,3
"degrees celcius",0,0,0,0,0,0,3,"DataOne",1,0,0,3
"degrees celsius (c)",0,0,0,0,0,0,3,"DataOne",1,0,0,3
"degrees latitude",0,0,0,0,0,0,3,"DataOne",1,0,0,3
"demchak 2005",0,0,0,0,0,0,3,"DataOne",1,0,0,3
"denicola 2013",0,0,0,0,0,0,3,"DataOne",1,0,0,3
"dic",0,0,0,0,0,0,3,"DataOne",1,0,0,3
"dietz-lafond",0,0,0,0,0,0,3,"DataOne",1,0,0,3
"dietz-lafond grab",0,0,0,0,0,0,3,"DataOne",1,0,0,3
"dietz-lafond snapper",0,0,0,0,0,0,3,"DataOne",1,0,0,3
"dn",0,0,0,0,0,0,3,"DataOne",1,0,0,3
"doc",0,0,0,0,0,0,3,"DataOne",1,0,0,3
"drag dredge",0,0,0,0,0,0,3,"DataOne",1,0,0,3
"dredge spoils",0,0,0,0,0,0,3,"DataOne",1,0,0,3
"drilled sample",0,0,0,0,0,0,3,"DataOne",1,0,0,3
"drilled sample",0,0,0,0,0,0,3,"DataOne",1,0,0,3
"dry",0,0,0,0,0,0,3,"DataOne",1,0,0,3
"edgerton camera",0,0,0,0,0,0,3,"DataOne",1,0,0,3
"edx",0,0,0,0,0,0,3,"DataOne",1,0,0,3
"exclusion",0,0,0,0,0,0,3,"DataOne",1,0,0,3
"exclusion area",0,0,0,0,0,0,3,"DataOne",1,0,0,3
"fine sand",0,0,0,0,0,0,3,"DataOne",1,0,0,3
"fine silt",0,0,0,0,0,0,3,"DataOne",1,0,0,3
"forest",0,0,0,0,0,0,3,"DataOne",1,0,0,3
"fox river",0,0,0,0,0,0,3,"DataOne",1,0,0,3
"frequency count",0,0,0,0,0,0,3,"DataOne",1,0,0,3
"fry",0,0,0,0,0,0,3,"DataOne",1,0,0,3
"ga",0,0,0,0,0,0,3,"DataOne",1,0,0,3
"generator",0,0,0,0,0,0,3,"DataOne",1,0,0,3
"gos anchor chain",0,0,0,0,0,0,3,"DataOne",1,0,0,3
"gr",0,0,0,0,0,0,3,"DataOne",1,0,0,3
"gramspergramperday",0,0,0,0,0,0,3,"DataOne",1,0,0,3
"gramsperkilogram",0,0,0,0,0,0,3,"DataOne",1,0,0,3
"grappling hook",0,0,0,0,0,0,3,"DataOne",1,0,0,3
"gravel",0,0,0,0,0,0,3,"DataOne",1,0,0,3
"gravel > 10%",0,0,0,0,0,0,3,"DataOne",1,0,0,3
"gv",0,0,0,0,0,0,3,"DataOne",1,0,0,3
"h",0,0,0,0,0,0,3,"DataOne",1,0,0,3
"h1",0,0,0,0,0,0,3,"DataOne",1,0,0,3
"hand sample",0,0,0,0,0,0,3,"DataOne",1,0,0,3
"hardbottom",0,0,0,0,0,0,3,"DataOne",1,0,0,3
"hectopascals",0,0,0,0,0,0,3,"DataOne",1,0,0,3
"height",0,0,0,0,0,0,3,"DataOne",1,0,0,3
"hhmm.xxx where xxx are decimal minutes when recorded",0,0,0,0,0,0,3,"DataOne",1,0,0,3
"hhmm.xxx where xxx are decimal minutes where recorded",0,0,0,0,0,0,3,"DataOne",1,0,0,3
"high",0,0,0,0,0,0,3,"DataOne",1,0,0,3
"horton creek",0,0,0,0,0,0,3,"DataOne",1,0,0,3
"hour in military time.",0,0,0,0,0,0,3,"DataOne",1,0,0,3
"hy",0,0,0,0,0,0,3,"DataOne",1,0,0,3
"hydrostatic corer",0,0,0,0,0,0,3,"DataOne",1,0,0,3
"hydrostatic corer",0,0,0,0,0,0,3,"DataOne",1,0,0,3
"individual fish",0,0,0,0,0,0,3,"DataOne",1,0,0,3
"interger count",0,0,0,0,0,0,3,"DataOne",1,0,0,3
"japanese dredge",0,0,0,0,0,0,3,"DataOne",1,0,0,3
"jtf",0,0,0,0,0,0,3,"DataOne",1,0,0,3
"julian day (year 2008)",0,0,0,0,0,0,3,"DataOne",1,0,0,3
"kelvin",0,0,0,0,0,0,3,"DataOne",1,0,0,3
"kilometers (km)",0,0,0,0,0,0,3,"DataOne",1,0,0,3
"km/h",0,0,0,0,0,0,3,"DataOne",1,0,0,3
"km/km2",0,0,0,0,0,0,3,"DataOne",1,0,0,3
"kws-2",0,0,0,0,0,0,3,"DataOne",1,0,0,3
"kws-3",0,0,0,0,0,0,3,"DataOne",1,0,0,3
"lagoon",0,0,0,0,0,0,3,"DataOne",1,0,0,3
"lagunitas seca",0,0,0,0,0,0,3,"DataOne",1,0,0,3
"lake",0,0,0,0,0,0,3,"DataOne",1,0,0,3
"lb",0,0,0,0,0,0,3,"DataOne",1,0,0,3
"livingston creek",0,0,0,0,0,0,3,"DataOne",1,0,0,3
"log of kilograms of nitrogen per square kilometer per year",0,0,0,0,0,0,3,"DataOne",1,0,0,3
"log of kilograms of nitrogen per year",0,0,0,0,0,0,3,"DataOne",1,0,0,3
"log of kilograms per square kilometer",0,0,0,0,0,0,3,"DataOne",1,0,0,3
"log of milligrams per liter",0,0,0,0,0,0,3,"DataOne",1,0,0,3
"low",0,0,0,0,0,0,3,"DataOne",1,0,0,3
"m-vv grab + d-lf snapper",0,0,0,0,0,0,3,"DataOne",1,0,0,3
"m-vv grab + gravity core",0,0,0,0,0,0,3,"DataOne",1,0,0,3
"m/s2",0,0,0,0,0,0,3,"DataOne",1,0,0,3
"m/yr",0,0,0,0,0,0,3,"DataOne",1,0,0,3
"m2",0,0,0,0,0,0,3,"DataOne",1,0,0,3
"magnitude",0,0,0,0,0,0,3,"DataOne",1,0,0,3
"martha stewart",0,0,0,0,0,0,3,"DataOne",1,0,0,3
"mcadam creek",0,0,0,0,0,0,3,"DataOne",1,0,0,3
"mcmaster1960",0,0,0,0,0,0,3,"DataOne",1,0,0,3
"mech arm + core drill",0,0,0,0,0,0,3,"DataOne",1,0,0,3
"mech arm w/ corer",0,0,0,0,0,0,3,"DataOne",1,0,0,3
"mech arm w/ pry bar",0,0,0,0,0,0,3,"DataOne",1,0,0,3
"mechanical arm",0,0,0,0,0,0,3,"DataOne",1,0,0,3
"medium sand",0,0,0,0,0,0,3,"DataOne",1,0,0,3
"medium silt",0,0,0,0,0,0,3,"DataOne",1,0,0,3
"megaripples",0,0,0,0,0,0,3,"DataOne",1,0,0,3
"meters (utm zone 19n wgs 84)",0,0,0,0,0,0,3,"DataOne",1,0,0,3
"meters squared",0,0,0,0,0,0,3,"DataOne",1,0,0,3
"mg",0,0,0,0,0,0,3,"DataOne",1,0,0,3
"mg g-1",0,0,0,0,0,0,3,"DataOne",1,0,0,3
"mg\\kg",0,0,0,0,0,0,3,"DataOne",1,0,0,3
"microeinsteinspersquaremeterpersecond",0,0,0,0,0,0,3,"DataOne",1,0,0,3
"microgrampercubicmeter",0,0,0,0,0,0,3,"DataOne",1,0,0,3
"microsiemens per centimeter (âµs/cm) at 25 degrees celsius",0,0,0,0,0,0,3,"DataOne",1,0,0,3
"mid",0,0,0,0,0,0,3,"DataOne",1,0,0,3
"milligram/liter",0,0,0,0,0,0,3,"DataOne",1,0,0,3
"milligrams of carbon dioxide per gram of rock",0,0,0,0,0,0,3,"DataOne",1,0,0,3
"milligrams per liter as silicon dioxide (mg/l as sio2)",0,0,0,0,0,0,3,"DataOne",1,0,0,3
"millimeters",0,0,0,0,0,0,3,"DataOne",1,0,0,3
"millimeters per year",0,0,0,0,0,0,3,"DataOne",1,0,0,3
"millimol per mol",0,0,0,0,0,0,3,"DataOne",1,0,0,3
"mini seaboss",0,0,0,0,0,0,3,"DataOne",1,0,0,3
"miniature van veen",0,0,0,0,0,0,3,"DataOne",1,0,0,3
"miniature van veen w/o c.",0,0,0,0,0,0,3,"DataOne",1,0,0,3
"mm/dd/yyyy hh:mm",0,0,0,0,0,0,3,"DataOne",1,0,0,3
"mmho/m, millimho per meter",0,0,0,0,0,0,3,"DataOne",1,0,0,3
"mmmm.xxx where xxx are decimal minutes when recorded",0,0,0,0,0,0,3,"DataOne",1,0,0,3
"mmmm.xxx where xxx are decimal minutes where recorded",0,0,0,0,0,0,3,"DataOne",1,0,0,3
"modified pierce dredge",0,0,0,0,0,0,3,"DataOne",1,0,0,3
"mog",0,0,0,0,0,0,3,"DataOne",1,0,0,3
"monbin",0,0,0,0,0,0,3,"DataOne",1,0,0,3
"mud",0,0,0,0,0,0,3,"DataOne",1,0,0,3
"name",0,0,0,0,0,0,3,"DataOne",1,0,0,3
"nanomol/kg",0,0,0,0,0,0,3,"DataOne",1,0,0,3
"nanomol/kg in water",0,0,0,0,0,0,3,"DataOne",1,0,0,3
"narragansett bay",0,0,0,0,0,0,3,"DataOne",1,0,0,3
"naturalist dredge",0,0,0,0,0,0,3,"DataOne",1,0,0,3
"nearshore basin",0,0,0,0,0,0,3,"DataOne",1,0,0,3
"nearshore ramp",0,0,0,0,0,0,3,"DataOne",1,0,0,3
"neva creek",0,0,0,0,0,0,3,"DataOne",1,0,0,3
"ninespine stickleback",0,0,0,0,0,0,3,"DataOne",1,0,0,3
"niskin sampler",0,0,0,0,0,0,3,"DataOne",1,0,0,3
"nmoles fe per kilogram of water (nmol fe/kg)",0,0,0,0,0,0,3,"DataOne",1,0,0,3
"no",0,0,0,0,0,0,3,"DataOne",1,0,0,3
"none",0,0,0,0,0,0,3,"DataOne",1,0,0,3
"north",0,0,0,0,0,0,3,"DataOne",1,0,0,3
"not applicable",0,0,0,0,0,0,3,"DataOne",1,0,0,3
"nt",0,0,0,0,0,0,3,"DataOne",1,0,0,3
"numeric code",0,0,0,0,0,0,3,"DataOne",1,0,0,3
"nure",0,0,0,0,0,0,3,"DataOne",1,0,0,3
"ocwa",0,0,0,0,0,0,3,"DataOne",1,0,0,3
"ohms.",0,0,0,0,0,0,3,"DataOne",1,0,0,3
"oil/fuel storage",0,0,0,0,0,0,3,"DataOne",1,0,0,3
"ok",0,0,0,0,0,0,3,"DataOne",1,0,0,3
"onebin",0,0,0,0,0,0,3,"DataOne",1,0,0,3
"osm 2013",0,0,0,0,0,0,3,"DataOne",1,0,0,3
"osm 2014",0,0,0,0,0,0,3,"DataOne",1,0,0,3
"outer basin",0,0,0,0,0,0,3,"DataOne",1,0,0,3
"paul corer",0,0,0,0,0,0,3,"DataOne",1,0,0,3
"percent modern",0,0,0,0,0,0,3,"DataOne",1,0,0,3
"pipe dredge and d-l snap",0,0,0,0,0,0,3,"DataOne",1,0,0,3
"pipe dredge, 12 inch",0,0,0,0,0,0,3,"DataOne",1,0,0,3
"piston corer",0,0,0,0,0,0,3,"DataOne",1,0,0,3
"polyline",0,0,0,0,0,0,3,"DataOne",1,0,0,3
"pom",0,0,0,0,0,0,3,"DataOne",1,0,0,3
"ponar sampler",0,0,0,0,0,0,3,"DataOne",1,0,0,3
"probbin",0,0,0,0,0,0,3,"DataOne",1,0,0,3
"pulse auger",0,0,0,0,0,0,3,"DataOne",1,0,0,3
"pulse auger",0,0,0,0,0,0,3,"DataOne",1,0,0,3
"push corer",0,0,0,0,0,0,3,"DataOne",1,0,0,3
"raked into basket w/ arm",0,0,0,0,0,0,3,"DataOne",1,0,0,3
"range from 0-6, can be 0-1, 1-3, 0-3, 3-6, 0-6",0,0,0,0,0,0,3,"DataOne",1,0,0,3
"reference",0,0,0,0,0,0,3,"DataOne",1,0,0,3
"rg",0,0,0,0,0,0,3,"DataOne",1,0,0,3
"ring net",0,0,0,0,0,0,3,"DataOne",1,0,0,3
"rocker dredge",0,0,0,0,0,0,3,"DataOne",1,0,0,3
"rocky zone",0,0,0,0,0,0,3,"DataOne",1,0,0,3
"rotary corer",0,0,0,0,0,0,3,"DataOne",1,0,0,3
"rotosonic corer",0,0,0,0,0,0,3,"DataOne",1,0,0,3
"rs",0,0,0,0,0,0,3,"DataOne",1,0,0,3
"salinometer, vandorn bots",0,0,0,0,0,0,3,"DataOne",1,0,0,3
"san sil clay",0,0,0,0,0,0,3,"DataOne",1,0,0,3
"sand silt clay",0,0,0,0,0,0,3,"DataOne",1,0,0,3
"scallop dredge",0,0,0,0,0,0,3,"DataOne",1,0,0,3
"scoop fish",0,0,0,0,0,0,3,"DataOne",1,0,0,3
"scour_outliers",0,0,0,0,0,0,3,"DataOne",1,0,0,3
"scp",0,0,0,0,0,0,3,"DataOne",1,0,0,3
"sculpin (scp) 0",0,0,0,0,0,0,3,"DataOne",1,0,0,3
"sd",0,0,0,0,0,0,3,"DataOne",1,0,0,3
"se",0,0,0,0,0,0,3,"DataOne",1,0,0,3
"seaboss",0,0,0,0,0,0,3,"DataOne",1,0,0,3
"second pass",0,0,0,0,0,0,3,"DataOne",1,0,0,3
"sequential shot number",0,0,0,0,0,0,3,"DataOne",1,0,0,3
"shipwreck",0,0,0,0,0,0,3,"DataOne",1,0,0,3
"small van veen",0,0,0,0,0,0,3,"DataOne",1,0,0,3
"smith-mac+min w, camera",0,0,0,0,0,0,3,"DataOne",1,0,0,3
"smith-macintyre w/ camera",0,0,0,0,0,0,3,"DataOne",1,0,0,3
"smith/mac and niskin spl",0,0,0,0,0,0,3,"DataOne",1,0,0,3
"solid",0,0,0,0,0,0,3,"DataOne",1,0,0,3
"south",0,0,0,0,0,0,3,"DataOne",1,0,0,3
"sp",0,0,0,0,0,0,3,"DataOne",1,0,0,3
"standard ph units",0,0,0,0,0,0,3,"DataOne",1,0,0,3
"steve",0,0,0,0,0,0,3,"DataOne",1,0,0,3
"structure",0,0,0,0,0,0,3,"DataOne",1,0,0,3
"submersible sample",0,0,0,0,0,0,3,"DataOne",1,0,0,3
"thorn 2014",0,0,0,0,0,0,3,"DataOne",1,0,0,3
"tiam",0,0,0,0,0,0,3,"DataOne",1,0,0,3
"tissue",0,0,0,0,0,0,3,"DataOne",1,0,0,3
"trawl",0,0,0,0,0,0,3,"DataOne",1,0,0,3
"trawl marks",0,0,0,0,0,0,3,"DataOne",1,0,0,3
"ulpu",0,0,0,0,0,0,3,"DataOne",1,0,0,3
"unit less",0,0,0,0,0,0,3,"DataOne",1,0,0,3
"unk",0,0,0,0,0,0,3,"DataOne",1,0,0,3
"us",0,0,0,0,0,0,3,"DataOne",1,0,0,3
"us/cm, microsiemens per centimeter",0,0,0,0,0,0,3,"DataOne",1,0,0,3
"usgs  hobba 1987",0,0,0,0,0,0,3,"DataOne",1,0,0,3
"usgs  sir 2012-5186",0,0,0,0,0,0,3,"DataOne",1,0,0,3
"usgs ferrel 1992",0,0,0,0,0,0,3,"DataOne",1,0,0,3
"van veen and core",0,0,0,0,0,0,3,"DataOne",1,0,0,3
"van veen grab",0,0,0,0,0,0,3,"DataOne",1,0,0,3
"vehicle",0,0,0,0,0,0,3,"DataOne",1,0,0,3
"very coarse sand",0,0,0,0,0,0,3,"DataOne",1,0,0,3
"very fine sand",0,0,0,0,0,0,3,"DataOne",1,0,0,3
"very fine silt",0,0,0,0,0,0,3,"DataOne",1,0,0,3
"vista coreopsis",0,0,0,0,0,0,3,"DataOne",1,0,0,3
"volts 370",0,0,0,0,0,0,3,"DataOne",1,0,0,3
"vv grab + d-l snapper",0,0,0,0,0,0,3,"DataOne",1,0,0,3
"w",0,0,0,0,0,0,3,"DataOne",1,0,0,3
"washington",0,0,0,0,0,0,3,"DataOne",1,0,0,3
"waste",0,0,0,0,0,0,3,"DataOne",1,0,0,3
"water",0,0,0,0,0,0,3,"DataOne",1,0,0,3
"water pump only",0,0,0,0,0,0,3,"DataOne",1,0,0,3
"watts-m2",0,0,0,0,0,0,3,"DataOne",1,0,0,3
"whoi giant gravity corer",0,0,0,0,0,0,3,"DataOne",1,0,0,3
"wi",0,0,0,0,0,0,3,"DataOne",1,0,0,3
"wiwa",0,0,0,0,0,0,3,"DataOne",1,0,0,3
"wreck/corallimorph",0,0,0,0,0,0,3,"DataOne",1,0,0,3
"wvdep 2016",0,0,0,0,0,0,3,"DataOne",1,0,0,3
"wvdep prenter",0,0,0,0,0,0,3,"DataOne",1,0,0,3
"wvdep slurry uic",0,0,0,0,0,0,3,"DataOne",1,0,0,3
"wvdep wab",0,0,0,0,0,0,3,"DataOne",1,0,0,3
"wvwri 2004",0,0,0,0,0,0,3,"DataOne",1,0,0,3
"xbt",0,0,0,0,0,0,3,"DataOne",1,0,0,3
"y, n, na",0,0,0,0,0,0,3,"DataOne",1,0,0,3
"yes",0,0,0,0,0,0,3,"DataOne",1,0,0,3
"# habitat layers",1,2,2,0,0,0,0,"EDI",1,1,2,2
"# litters/year",1,2,2,0,0,0,0,"EDI",1,1,2,2
"# offspring",1,2,2,0,0,0,0,"EDI",1,1,2,2
"# teats",1,2,2,0,0,0,0,"EDI",1,1,2,2
"absorbanceunits",2,2,2,0,0,0,0,"EDI",1,2,2,2
"angstrom-squared",1,2,2,0,0,0,0,"EDI",1,1,2,2
"arbitrary unit",1,2,2,0,0,0,0,"EDI",1,1,2,2
"becquerelpermilligram",1,2,2,0,0,0,0,"EDI",1,1,2,2
"byte",1,2,2,0,0,0,0,"EDI",1,1,2,2
"catchperuniteffort",1,2,2,0,0,0,0,"EDI",1,1,2,2
"centimeterpermetersquared",1,2,2,0,0,0,0,"EDI",1,1,2,2
"centimeterperyear",2,2,2,0,0,0,0,"EDI",1,2,2,2
"count/m^2",1,2,2,0,0,0,0,"EDI",1,1,2,2
"cubic meters per hectare",1,2,2,0,0,0,0,"EDI",1,1,2,2
"dd/mm/yy",1,2,2,0,0,0,0,"EDI",1,1,2,2
"degcelcius",1,2,2,0,0,0,0,"EDI",1,1,2,2
"formazinnephelometricunits",2,2,2,0,0,0,0,"EDI",1,2,2,2
"grampercentimetersquared",2,2,2,0,0,0,0,"EDI",1,2,2,2
"in the next field",1,2,2,0,0,0,0,"EDI",1,1,2,2
"inversemeter",2,2,2,0,0,0,0,"EDI",1,2,2,2
"joulepergram",1,2,2,0,0,0,0,"EDI",1,1,2,2
"joulespermetersquared",2,2,2,0,0,0,0,"EDI",1,2,2,2
"kilograms",1,2,2,0,0,0,0,"EDI",1,1,2,2
"latitude",1,2,2,0,0,0,0,"EDI",1,1,2,2
"literpermilligrampermeter",2,2,2,0,0,0,0,"EDI",1,2,2,2
"litters/year",1,2,2,0,0,0,0,"EDI",1,1,2,2
"mdl unit",1,2,2,0,0,0,0,"EDI",1,1,2,2
"metercubedpermeterperyear",1,2,2,0,0,0,0,"EDI",1,1,2,2
"meterperyear",1,2,2,0,0,0,0,"EDI",1,1,2,2
"microeinsteinspermetersquaredpersecond",1,2,2,0,0,0,0,"EDI",1,1,2,2
"microgram c/g soil",1,2,2,0,0,0,0,"EDI",1,1,2,2
"microgram n/g soil",1,2,2,0,0,0,0,"EDI",1,1,2,2
"micrograms per gram per week",1,2,2,0,0,0,0,"EDI",1,1,2,2
"micrograms per second",1,2,2,0,0,0,0,"EDI",1,1,2,2
"microgramspersquaremeter",2,2,2,0,0,0,0,"EDI",1,2,2,2
"micrometercubedperliter",2,2,2,0,0,0,0,"EDI",1,2,2,2
"micromoles per gram per hour",1,2,2,0,0,0,0,"EDI",1,1,2,2
"micromoles per liter",2,2,2,0,0,0,0,"EDI",1,2,2,2
"micromolespermole",1,2,2,0,0,0,0,"EDI",1,1,2,2
"micromolespersquaremeterpersecond	",1,2,2,0,0,0,0,"EDI",1,1,2,2
"milligrampermilligramperday",1,2,2,0,0,0,0,"EDI",1,1,2,2
"millimeterperhour",2,2,2,0,0,0,0,"EDI",1,2,2,2
"millimolespermetersquareperday",2,2,2,0,0,0,0,"EDI",1,2,2,2
"mmole/liter",1,2,2,0,0,0,0,"EDI",1,1,2,2
"nanograms per gram per hour",1,2,2,0,0,0,0,"EDI",1,1,2,2
"number of species",1,2,2,0,0,0,0,"EDI",1,1,2,2
"picogramspergram",1,2,2,0,0,0,0,"EDI",1,1,2,2
"practicalsalinityunit",1,2,2,0,0,0,0,"EDI",1,1,2,2
"rate increase",1,2,2,0,0,0,0,"EDI",1,1,2,2
"rotations",1,2,2,0,0,0,0,"EDI",1,1,2,2
"siemenspermeter",1,2,2,0,0,0,0,"EDI",1,1,2,2
"squarecentimeterpergram",2,2,2,0,0,0,0,"EDI",1,2,2,2
"squarefoot",2,2,2,0,0,0,0,"EDI",1,2,2,2
"squaremetersperhectare",1,2,2,0,0,0,0,"EDI",1,1,2,2
"thousands of seeds per acre",1,2,2,0,0,0,0,"EDI",1,1,2,2
"ugn/gdrymoss/day",1,2,2,0,0,0,0,"EDI",1,1,2,2
"yyyy/mm/dd",1,2,2,0,0,0,0,"EDI",1,1,2,2
"
                metersquaredpermetersquared",1,1,2,0,0,0,0,"EDI",1,1,1,2
"#ofcryptophytes/ciliate/hour",1,1,2,0,0,0,0,"EDI",1,1,1,2
"#x105/liter",1,1,2,0,0,0,0,"EDI",1,1,1,2
"% dry wt",1,1,2,0,0,0,0,"EDI",1,1,1,2
"+acu-",1,1,2,0,0,0,0,"EDI",1,1,1,2
"°c",1,1,2,0,0,0,0,"EDI",1,1,1,2
"µg l-1",1,1,2,0,0,0,0,"EDI",1,1,1,2
"µs/cm",1,1,2,0,0,0,0,"EDI",1,1,1,2
"100g",1,1,2,0,0,0,0,"EDI",1,1,1,2
"abundance_ind./m²",1,1,2,0,0,0,0,"EDI",1,1,1,2
"block",1,1,2,0,0,0,0,"EDI",1,1,1,2
"board number",1,1,2,0,0,0,0,"EDI",1,1,1,2
"boardfoot",1,1,2,0,0,0,0,"EDI",1,1,1,2
"cardinal directions",1,1,2,0,0,0,0,"EDI",1,1,1,2
"cells/ml",1,1,2,0,0,0,0,"EDI",1,1,1,2
"center of mass",1,1,2,0,0,0,0,"EDI",1,1,1,2
"centigram",1,1,2,0,0,0,0,"EDI",1,1,1,2
"centimetersquaredpermetersquared",1,1,2,0,0,0,0,"EDI",1,1,1,2
"centimetres",1,1,2,0,0,0,0,"EDI",1,1,1,2
"copygenepergramdrysoil",1,1,2,0,0,0,0,"EDI",1,1,1,2
"coral",1,1,2,0,0,0,0,"EDI",1,1,1,2
"cubic foot per second",1,1,2,0,0,0,0,"EDI",1,1,1,2
"cubicfeetpersecond",1,1,2,0,0,0,0,"EDI",1,1,1,2
"cubicmetersperyear",1,1,2,0,0,0,0,"EDI",1,1,1,2
"cubicmicrometers",1,1,2,0,0,0,0,"EDI",1,1,1,2
"cubicmillimeter",1,1,2,0,0,0,0,"EDI",1,1,1,2
"day of the year",1,1,2,0,0,0,0,"EDI",1,1,1,2
"decimal de",1,1,2,0,0,0,0,"EDI",1,1,1,2
"decimaldegrees",1,1,2,0,0,0,0,"EDI",1,1,1,2
"decimaldegrees (dd)",1,1,2,0,0,0,0,"EDI",1,1,1,2
"decimaldegreeslatitudeorlongitude",1,1,2,0,0,0,0,"EDI",1,1,1,2
"decimalhours",1,1,2,0,0,0,0,"EDI",1,1,1,2
"decisiemenpermeter",1,1,2,0,0,0,0,"EDI",1,1,1,2
"degreees latitude or longitude",1,1,2,0,0,0,0,"EDI",1,1,1,2
"degreeminute",1,1,2,0,0,0,0,"EDI",1,1,1,2
"degreesdecimal",1,1,2,0,0,0,0,"EDI",1,1,1,2
"dollar",1,1,2,0,0,0,0,"EDI",1,1,1,2
"dollars (2016)",1,1,2,0,0,0,0,"EDI",1,1,1,2
"femtogrampernumber",1,1,2,0,0,0,0,"EDI",1,1,1,2
"fracdoy",1,1,2,0,0,0,0,"EDI",1,1,1,2
"fraction",1,1,2,0,0,0,0,"EDI",1,1,1,2
"g/g soil",1,1,2,0,0,0,0,"EDI",1,1,1,2
"gbiomass/m^2",1,1,2,0,0,0,0,"EDI",1,1,1,2
"gdryweight",1,1,2,0,0,0,0,"EDI",1,1,1,2
"gps.datum:wsg84positionformat:hddd.ddddd",1,1,2,0,0,0,0,"EDI",1,1,1,2
"gramcentimeter",1,1,2,0,0,0,0,"EDI",1,1,1,2
"grampercubicmillimeter",1,1,2,0,0,0,0,"EDI",1,1,1,2
"gramperdecimetersquared",1,1,2,0,0,0,0,"EDI",1,1,1,2
"grams of carbon per kilogram of soil",1,1,2,0,0,0,0,"EDI",1,1,1,2
"grams of nitrogen per kilogram of soil",1,1,2,0,0,0,0,"EDI",1,1,1,2
"inchesperhourtimes100",1,1,2,0,0,0,0,"EDI",1,1,1,2
"integer code",1,1,2,0,0,0,0,"EDI",1,1,1,2
"joulesperkilogram",1,1,2,0,0,0,0,"EDI",1,1,1,2
"joulespersquaremeter",1,1,2,0,0,0,0,"EDI",1,1,1,2
"kilogramscarbonpersquarekilometerperday",1,1,2,0,0,0,0,"EDI",1,1,1,2
"kilogramsperkilometersquareperyear",1,1,2,0,0,0,0,"EDI",1,1,1,2
"kilometercubed",1,1,2,0,0,0,0,"EDI",1,1,1,2
"kilopascals",1,1,2,0,0,0,0,"EDI",1,1,1,2
"l/mg-m",1,1,2,0,0,0,0,"EDI",1,1,1,2
"ldm-2hr-1",1,1,2,0,0,0,0,"EDI",1,1,1,2
"literpermilligramcarbonmeter",1,1,2,0,0,0,0,"EDI",1,1,1,2
"literpermilligrammeter",1,1,2,0,0,0,0,"EDI",1,1,1,2
"literpermilligrampermetersquared",1,1,2,0,0,0,0,"EDI",1,1,1,2
"literspermilligramcarbonpermeter",1,1,2,0,0,0,0,"EDI",1,1,1,2
"log10seed count per seed trap",1,1,2,0,0,0,0,"EDI",1,1,1,2
"mega joules",1,1,2,0,0,0,0,"EDI",1,1,1,2
"megabyte",1,1,2,0,0,0,0,"EDI",1,1,1,2
"megajoule per m2",1,1,2,0,0,0,0,"EDI",1,1,1,2
"megajoulespersquaremeter",1,1,2,0,0,0,0,"EDI",1,1,1,2
"meter squares",1,1,2,0,0,0,0,"EDI",1,1,1,2
"metercubedpersecondperkilometersquared",1,1,2,0,0,0,0,"EDI",1,1,1,2
"metersquaredperhectareperyear",1,1,2,0,0,0,0,"EDI",1,1,1,2
"metersquaredperpixel",1,1,2,0,0,0,0,"EDI",1,1,1,2
"mg c / l",1,1,2,0,0,0,0,"EDI",1,1,1,2
"mg c/g soil",1,1,2,0,0,0,0,"EDI",1,1,1,2
"mg n / l",1,1,2,0,0,0,0,"EDI",1,1,1,2
"mg no3-n / l",1,1,2,0,0,0,0,"EDI",1,1,1,2
"mg/ha",1,1,2,0,0,0,0,"EDI",1,1,1,2
"mg/s/m",1,1,2,0,0,0,0,"EDI",1,1,1,2
"mgcm^-2h^-1",1,1,2,0,0,0,0,"EDI",1,1,1,2
"mgn/kgdrysoil",1,1,2,0,0,0,0,"EDI",1,1,1,2
"microeinsteins/m^2/second",1,1,2,0,0,0,0,"EDI",1,1,1,2
"microequivalentsperkilogram",1,1,2,0,0,0,0,"EDI",1,1,1,2
"microgofcarbon/liter",1,1,2,0,0,0,0,"EDI",1,1,1,2
"microgramnpergramdrysoilperday",1,1,2,0,0,0,0,"EDI",1,1,1,2
"microgrampercentimetersquaredperday",1,1,2,0,0,0,0,"EDI",1,1,1,2
"microgrampercount",1,1,2,0,0,0,0,"EDI",1,1,1,2
"microgramperday",1,1,2,0,0,0,0,"EDI",1,1,1,2
"microgrampergramperday",1,1,2,0,0,0,0,"EDI",1,1,1,2
"microgrampermetersquared",1,1,2,0,0,0,0,"EDI",1,1,1,2
"microgrampermetersquaredperminute",1,1,2,0,0,0,0,"EDI",1,1,1,2
"micrograms",1,1,2,0,0,0,0,"EDI",1,1,1,2
"microgramspercentimeter",1,1,2,0,0,0,0,"EDI",1,1,1,2
"microgramspergrampermin",1,1,2,0,0,0,0,"EDI",1,1,1,2
"microgramsperresinbag",1,1,2,0,0,0,0,"EDI",1,1,1,2
"microgramspersquaremeterperday",1,1,2,0,0,0,0,"EDI",1,1,1,2
"microlitersperliter",1,1,2,0,0,0,0,"EDI",1,1,1,2
"micromol per kilogram of seawater",1,1,2,0,0,0,0,"EDI",1,1,1,2
"micromolepercountperminute",1,1,2,0,0,0,0,"EDI",1,1,1,2
"micromolepergramperhour",1,1,2,0,0,0,0,"EDI",1,1,1,2
"micromoleperliterperhour",1,1,2,0,0,0,0,"EDI",1,1,1,2
"micromolepermilligram",1,1,2,0,0,0,0,"EDI",1,1,1,2
"micromolepersquaremeterperday",1,1,2,0,0,0,0,"EDI",1,1,1,2
"micromolepersquaremeterpersecond",1,1,2,0,0,0,0,"EDI",1,1,1,2
"micromoles per gram",1,1,2,0,0,0,0,"EDI",1,1,1,2
"micromoles per gram per day",1,1,2,0,0,0,0,"EDI",1,1,1,2
"micromolespermetersuaredpersecond",1,1,2,0,0,0,0,"EDI",1,1,1,2
"micromolespersquarecentimeterperhour",1,1,2,0,0,0,0,"EDI",1,1,1,2
"micromolpersquaremeterpersecond",1,1,2,0,0,0,0,"EDI",1,1,1,2
"micros.cm-2",1,1,2,0,0,0,0,"EDI",1,1,1,2
"milimeterpermonth",1,1,2,0,0,0,0,"EDI",1,1,1,2
"milli siemens per centimeter",1,1,2,0,0,0,0,"EDI",1,1,1,2
"milliequivalentsperhectogram",1,1,2,0,0,0,0,"EDI",1,1,1,2
"milligramcarbonpermetersquaredperday",1,1,2,0,0,0,0,"EDI",1,1,1,2
"milligramgramperkilogramperday",1,1,2,0,0,0,0,"EDI",1,1,1,2
"milligramperhour",1,1,2,0,0,0,0,"EDI",1,1,1,2
"milligramperliter ",1,1,2,0,0,0,0,"EDI",1,1,1,2
"milligramperliterasphosphorus",1,1,2,0,0,0,0,"EDI",1,1,1,2
"milligramsperday",1,1,2,0,0,0,0,"EDI",1,1,1,2
"millimetersperhour",1,1,2,0,0,0,0,"EDI",1,1,1,2
"millimolepermetersquaredpernight",1,1,2,0,0,0,0,"EDI",1,1,1,2
"millimolepermolepersecond",1,1,2,0,0,0,0,"EDI",1,1,1,2
"millimolepersquaredmeterperhour",1,1,2,0,0,0,0,"EDI",1,1,1,2
"millimolesperliter",1,1,2,0,0,0,0,"EDI",1,1,1,2
"millionacrefeet",1,1,2,0,0,0,0,"EDI",1,1,1,2
"millivoltspermillivolt",1,1,2,0,0,0,0,"EDI",1,1,1,2
"milliwattpermetersquaredpersteradianpernanometer",1,1,2,0,0,0,0,"EDI",1,1,1,2
"missing value code",1,1,2,0,0,0,0,"EDI",1,1,1,2
"mol per liter per atmosphere",1,1,2,0,0,0,0,"EDI",1,1,1,2
"molespermetersquareperday",1,1,2,0,0,0,0,"EDI",1,1,1,2
"mpa",1,1,2,0,0,0,0,"EDI",1,1,1,2
"nanogrampercubicmeter",1,1,2,0,0,0,0,"EDI",1,1,1,2
"nanogrampermilliliter",1,1,2,0,0,0,0,"EDI",1,1,1,2
"nanogramspermilliliter",1,1,2,0,0,0,0,"EDI",1,1,1,2
"nanometers",1,1,2,0,0,0,0,"EDI",1,1,1,2
"nanomolepercountperminute",1,1,2,0,0,0,0,"EDI",1,1,1,2
"nanomolepersquarecentimeterperhour",1,1,2,0,0,0,0,"EDI",1,1,1,2
"nephelometricturbidityunit",1,1,2,0,0,0,0,"EDI",1,1,1,2
"number of hours",1,1,2,0,0,0,0,"EDI",1,1,1,2
"number of individuals",1,1,2,0,0,0,0,"EDI",1,1,1,2
"number of species",1,1,2,0,0,0,0,"EDI",1,1,1,2
"number of transects",1,1,2,0,0,0,0,"EDI",1,1,1,2
"numberofyears",1,1,2,0,0,0,0,"EDI",1,1,1,2
"p-value",1,1,2,0,0,0,0,"EDI",1,1,1,2
"partsperhundred",1,1,2,0,0,0,0,"EDI",1,1,1,2
"partspermillionperminute",1,1,2,0,0,0,0,"EDI",1,1,1,2
"partspermillionpersecond",1,1,2,0,0,0,0,"EDI",1,1,1,2
"per 1000",1,1,2,0,0,0,0,"EDI",1,1,1,2
"per mil.",1,1,2,0,0,0,0,"EDI",1,1,1,2
"per mille",1,1,2,0,0,0,0,"EDI",1,1,1,2
"percentdrymass",1,1,2,0,0,0,0,"EDI",1,1,1,2
"permeter",1,1,2,0,0,0,0,"EDI",1,1,1,2
"permetersquared",1,1,2,0,0,0,0,"EDI",1,1,1,2
"permill",1,1,2,0,0,0,0,"EDI",1,1,1,2
"perthousand",1,1,2,0,0,0,0,"EDI",1,1,1,2
"probability",1,1,2,0,0,0,0,"EDI",1,1,1,2
"psu",1,1,2,0,0,0,0,"EDI",1,1,1,2
"quadrat number",1,1,2,0,0,0,0,"EDI",1,1,1,2
"rawfluorescenceunits",1,1,2,0,0,0,0,"EDI",1,1,1,2
"reciprocalmin",1,1,2,0,0,0,0,"EDI",1,1,1,2
"relative differences in ranks",1,1,2,0,0,0,0,"EDI",1,1,1,2
"relativefluorescentunit",1,1,2,0,0,0,0,"EDI",1,1,1,2
"seed count per seed trap",1,1,2,0,0,0,0,"EDI",1,1,1,2
"siemenpercentimeter",1,1,2,0,0,0,0,"EDI",1,1,1,2
"spei standardized units",1,1,2,0,0,0,0,"EDI",1,1,1,2
"speices differences ",1,1,2,0,0,0,0,"EDI",1,1,1,2
"squaremicrometer",1,1,2,0,0,0,0,"EDI",1,1,1,2
"taxon code",1,1,2,0,0,0,0,"EDI",1,1,1,2
"ton/ha",1,1,2,0,0,0,0,"EDI",1,1,1,2
"trap per date",1,1,2,0,0,0,0,"EDI",1,1,1,2
"ug-n/g dry soil/day",1,1,2,0,0,0,0,"EDI",1,1,1,2
"ugc/cm2",1,1,2,0,0,0,0,"EDI",1,1,1,2
"unitless (normalized data)",1,1,2,0,0,0,0,"EDI",1,1,1,2
"us dollars",1,1,2,0,0,0,0,"EDI",1,1,1,2
"v/v",1,1,2,0,0,0,0,"EDI",1,1,1,2
"watthourspermetersquared",1,1,2,0,0,0,0,"EDI",1,1,1,2
"week of year",1,1,2,0,0,0,0,"EDI",1,1,1,2
"weekofyear",1,1,2,0,0,0,0,"EDI",1,1,1,2
"wgs 84",1,1,2,0,0,0,0,"EDI",1,1,1,2
"wgs84",1,1,2,0,0,0,0,"EDI",1,1,1,2
"-1",0,0,0,0,0,0,2,"DataOne",1,0,0,2
"-6",0,0,0,0,0,0,2,"DataOne",1,0,0,2
"-83",0,0,0,0,0,0,2,"DataOne",1,0,0,2
"""north america"",  ""central america and the caribbean"",  ""south america"",  ""eastern australia"",  ""southeast asia archipelagos"",  ""central  and eastern asia"",  ""northeast asia"",  ""southeast asia"", ""middle east"", ""europe"", ""global""",0,0,0,0,0,0,2,"DataOne",1,0,0,2
"(mg/l as caco3)",0,0,0,0,0,0,2,"DataOne",1,0,0,2
"{null}",0,0,0,0,0,0,2,"DataOne",1,0,0,2
"<blank>",0,0,0,0,0,0,2,"DataOne",1,0,0,2
"100 meter",0,0,0,0,0,0,2,"DataOne",1,0,0,2
"15r",0,0,0,0,0,0,2,"DataOne",1,0,0,2
"16r",0,0,0,0,0,0,2,"DataOne",1,0,0,2
"19820203",0,0,0,0,0,0,2,"DataOne",1,0,0,2
"19820223",0,0,0,0,0,0,2,"DataOne",1,0,0,2
"2",0,0,0,0,0,0,2,"DataOne",1,0,0,2
"2004",0,0,0,0,0,0,2,"DataOne",1,0,0,2
"2005",0,0,0,0,0,0,2,"DataOne",1,0,0,2
"2009",0,0,0,0,0,0,2,"DataOne",1,0,0,2
"2010-010-fa",0,0,0,0,0,0,2,"DataOne",1,0,0,2
"2010-015-fa",0,0,0,0,0,0,2,"DataOne",1,0,0,2
"206",0,0,0,0,0,0,2,"DataOne",1,0,0,2
"211",0,0,0,0,0,0,2,"DataOne",1,0,0,2
"3",0,0,0,0,0,0,2,"DataOne",1,0,0,2
"3/4 meter plankton net",0,0,0,0,0,0,2,"DataOne",1,0,0,2
"32",0,0,0,0,0,0,2,"DataOne",1,0,0,2
"4",0,0,0,0,0,0,2,"DataOne",1,0,0,2
"4",0,0,0,0,0,0,2,"DataOne",1,0,0,2
"40",0,0,0,0,0,0,2,"DataOne",1,0,0,2
"42",0,0,0,0,0,0,2,"DataOne",1,0,0,2
"42837",0,0,0,0,0,0,2,"DataOne",1,0,0,2
"5",0,0,0,0,0,0,2,"DataOne",1,0,0,2
"6",0,0,0,0,0,0,2,"DataOne",1,0,0,2
"60101",0,0,0,0,0,0,2,"DataOne",1,0,0,2
"60102",0,0,0,0,0,0,2,"DataOne",1,0,0,2
"60103",0,0,0,0,0,0,2,"DataOne",1,0,0,2
"60104",0,0,0,0,0,0,2,"DataOne",1,0,0,2
"60201",0,0,0,0,0,0,2,"DataOne",1,0,0,2
"60202",0,0,0,0,0,0,2,"DataOne",1,0,0,2
"60203",0,0,0,0,0,0,2,"DataOne",1,0,0,2
"60204",0,0,0,0,0,0,2,"DataOne",1,0,0,2
"60205",0,0,0,0,0,0,2,"DataOne",1,0,0,2
"60206",0,0,0,0,0,0,2,"DataOne",1,0,0,2
"60301",0,0,0,0,0,0,2,"DataOne",1,0,0,2
"60302",0,0,0,0,0,0,2,"DataOne",1,0,0,2
"60303",0,0,0,0,0,0,2,"DataOne",1,0,0,2
"60304",0,0,0,0,0,0,2,"DataOne",1,0,0,2
"60401",0,0,0,0,0,0,2,"DataOne",1,0,0,2
"60402",0,0,0,0,0,0,2,"DataOne",1,0,0,2
"60403",0,0,0,0,0,0,2,"DataOne",1,0,0,2
"60404",0,0,0,0,0,0,2,"DataOne",1,0,0,2
"60501",0,0,0,0,0,0,2,"DataOne",1,0,0,2
"60502",0,0,0,0,0,0,2,"DataOne",1,0,0,2
"60503",0,0,0,0,0,0,2,"DataOne",1,0,0,2
"60504",0,0,0,0,0,0,2,"DataOne",1,0,0,2
"60601",0,0,0,0,0,0,2,"DataOne",1,0,0,2
"60602",0,0,0,0,0,0,2,"DataOne",1,0,0,2
"60603",0,0,0,0,0,0,2,"DataOne",1,0,0,2
"7",0,0,0,0,0,0,2,"DataOne",1,0,0,2
"7.5",0,0,0,0,0,0,2,"DataOne",1,0,0,2
"âµgn/gdw",0,0,0,0,0,0,2,"DataOne",1,0,0,2
"a1 r_cgs",0,0,0,0,0,0,2,"DataOne",1,0,0,2
"a2 i_cgs",0,0,0,0,0,0,2,"DataOne",1,0,0,2
"aa",0,0,0,0,0,0,2,"DataOne",1,0,0,2
"aa_cv",0,0,0,0,0,0,2,"DataOne",1,0,0,2
"aa_gf_hbr",0,0,0,0,0,0,2,"DataOne",1,0,0,2
"abundant",0,0,0,0,0,0,2,"DataOne",1,0,0,2
"acp",0,0,0,0,0,0,2,"DataOne",1,0,0,2
"add sample",0,0,0,0,0,0,2,"DataOne",1,0,0,2
"adult frog (atf) 0",0,0,0,0,0,0,2,"DataOne",1,0,0,2
"adult frog (atf) 1",0,0,0,0,0,0,2,"DataOne",1,0,0,2
"adult frog (atf) 2",0,0,0,0,0,0,2,"DataOne",1,0,0,2
"adult frog (atf) 3",0,0,0,0,0,0,2,"DataOne",1,0,0,2
"aef",0,0,0,0,0,0,2,"DataOne",1,0,0,2
"aes",0,0,0,0,0,0,2,"DataOne",1,0,0,2
"aes_az_p",0,0,0,0,0,0,2,"DataOne",1,0,0,2
"aes_st",0,0,0,0,0,0,2,"DataOne",1,0,0,2
"alaska",0,0,0,0,0,0,2,"DataOne",1,0,0,2
"alaska blackfish",0,0,0,0,0,0,2,"DataOne",1,0,0,2
"all",0,0,0,0,0,0,2,"DataOne",1,0,0,2
"almagosa",0,0,0,0,0,0,2,"DataOne",1,0,0,2
"almagosa_west",0,0,0,0,0,0,2,"DataOne",1,0,0,2
"american",0,0,0,0,0,0,2,"DataOne",1,0,0,2
"amgp",0,0,0,0,0,0,2,"DataOne",1,0,0,2
"ampi",0,0,0,0,0,0,2,"DataOne",1,0,0,2
"amro",0,0,0,0,0,0,2,"DataOne",1,0,0,2
"anchor dredge",0,0,0,0,0,0,2,"DataOne",1,0,0,2
"ar",0,0,0,0,0,0,2,"DataOne",1,0,0,2
"arwa",0,0,0,0,0,0,2,"DataOne",1,0,0,2
"ashuelot river (nh)",0,0,0,0,0,0,2,"DataOne",1,0,0,2
"at",0,0,0,0,0,0,2,"DataOne",1,0,0,2
"atf",0,0,0,0,0,0,2,"DataOne",1,0,0,2
"atl (atlantic), mis (mississippi, cen (central), and pac (pacific)",0,0,0,0,0,0,2,"DataOne",1,0,0,2
"atsp",0,0,0,0,0,0,2,"DataOne",1,0,0,2
"az",0,0,0,0,0,0,2,"DataOne",1,0,0,2
"b r_cgs / i_cbg",0,0,0,0,0,0,2,"DataOne",1,0,0,2
"backshore",0,0,0,0,0,0,2,"DataOne",1,0,0,2
"barrierinterior",0,0,0,0,0,0,2,"DataOne",1,0,0,2
"beach",0,0,0,0,0,0,2,"DataOne",1,0,0,2
"beach",0,0,0,0,0,0,2,"DataOne",1,0,0,2
"bedforms",0,0,0,0,0,0,2,"DataOne",1,0,0,2
"bedrock or boulders",0,0,0,0,0,0,2,"DataOne",1,0,0,2
"bef",0,0,0,0,0,0,2,"DataOne",1,0,0,2
"bft",0,0,0,0,0,0,2,"DataOne",1,0,0,2
"bhef",0,0,0,0,0,0,2,"DataOne",1,0,0,2
"big seaboss grab",0,0,0,0,0,0,2,"DataOne",1,0,0,2
"binary",0,0,0,0,0,0,2,"DataOne",1,0,0,2
"bird",0,0,0,0,0,0,2,"DataOne",1,0,0,2
"bird_id",0,0,0,0,0,0,2,"DataOne",1,0,0,2
"birds",0,0,0,0,0,0,2,"DataOne",1,0,0,2
"ble",0,0,0,0,0,0,2,"DataOne",1,0,0,2
"blpw",0,0,0,0,0,0,2,"DataOne",1,0,0,2
"blue",0,0,0,0,0,0,2,"DataOne",1,0,0,2
"boch",0,0,0,0,0,0,2,"DataOne",1,0,0,2
"boulders",0,0,0,0,0,0,2,"DataOne",1,0,0,2
"british columbia",0,0,0,0,0,0,2,"DataOne",1,0,0,2
"broad whitefish",0,0,0,0,0,0,2,"DataOne",1,0,0,2
"btcu",0,0,0,0,0,0,2,"DataOne",1,0,0,2
"butte",0,0,0,0,0,0,2,"DataOne",1,0,0,2
"c i_cbg",0,0,0,0,0,0,2,"DataOne",1,0,0,2
"c, degrees celsius",0,0,0,0,0,0,2,"DataOne",1,0,0,2
"c1",0,0,0,0,0,0,2,"DataOne",1,0,0,2
"c2",0,0,0,0,0,0,2,"DataOne",1,0,0,2
"cago",0,0,0,0,0,0,2,"DataOne",1,0,0,2
"calanoida",0,0,0,0,0,0,2,"DataOne",1,0,0,2
"calle cerrado",0,0,0,0,0,0,2,"DataOne",1,0,0,2
"capecod",0,0,0,0,0,0,2,"DataOne",1,0,0,2
"categorical",0,0,0,0,0,0,2,"DataOne",1,0,0,2
"cave passage",0,0,0,0,0,0,2,"DataOne",1,0,0,2
"cave passage1",0,0,0,0,0,0,2,"DataOne",1,0,0,2
"cave passage2",0,0,0,0,0,0,2,"DataOne",1,0,0,2
"cave passage3",0,0,0,0,0,0,2,"DataOne",1,0,0,2
"cb",0,0,0,0,0,0,2,"DataOne",1,0,0,2
"cef",0,0,0,0,0,0,2,"DataOne",1,0,0,2
"centimeters (cm)",0,0,0,0,0,0,2,"DataOne",1,0,0,2
"cgbt",0,0,0,0,0,0,2,"DataOne",1,0,0,2
"channel",0,0,0,0,0,0,2,"DataOne",1,0,0,2
"chesapeake",0,0,0,0,0,0,2,"DataOne",1,0,0,2
"cl",0,0,0,0,0,0,2,"DataOne",1,0,0,2
"cm/m2",0,0,0,0,0,0,2,"DataOne",1,0,0,2
"co",0,0,0,0,0,0,2,"DataOne",1,0,0,2
"coarse pebbles",0,0,0,0,0,0,2,"DataOne",1,0,0,2
"coastal water",0,0,0,0,0,0,2,"DataOne",1,0,0,2
"colusa",0,0,0,0,0,0,2,"DataOne",1,0,0,2
"composite",0,0,0,0,0,0,2,"DataOne",1,0,0,2
"control",0,0,0,0,0,0,2,"DataOne",1,0,0,2
"cora",0,0,0,0,0,0,2,"DataOne",1,0,0,2
"count of hours",0,0,0,0,0,0,2,"DataOne",1,0,0,2
"craib corer",0,0,0,0,0,0,2,"DataOne",1,0,0,2
"crd",0,0,0,0,0,0,2,"DataOne",1,0,0,2
"created",0,0,0,0,0,0,2,"DataOne",1,0,0,2
"crete creek",0,0,0,0,0,0,2,"DataOne",1,0,0,2
"cs",0,0,0,0,0,0,2,"DataOne",1,0,0,2
"cs",0,0,0,0,0,0,2,"DataOne",1,0,0,2
"csc data",0,0,0,0,0,0,2,"DataOne",1,0,0,2
"cubic feet per second (cfs)",0,0,0,0,0,0,2,"DataOne",1,0,0,2
"cubic meters per second",0,0,0,0,0,0,2,"DataOne",1,0,0,2
"cubic meters per second",0,0,0,0,0,0,2,"DataOne",1,0,0,2
"d",0,0,0,0,0,0,2,"DataOne",1,0,0,2
"d1 i_cgs / pcbg",0,0,0,0,0,0,2,"DataOne",1,0,0,2
"d2 i_mcgs / pcbg",0,0,0,0,0,0,2,"DataOne",1,0,0,2
"date - mm/dd/yyyy",0,0,0,0,0,0,2,"DataOne",1,0,0,2
"date (mm/dd/yyy)",0,0,0,0,0,0,2,"DataOne",1,0,0,2
"date, defined as mm/dd/yyyy",0,0,0,0,0,0,2,"DataOne",1,0,0,2
"db",0,0,0,0,0,0,2,"DataOne",1,0,0,2
"db",0,0,0,0,0,0,2,"DataOne",1,0,0,2
"dbar",0,0,0,0,0,0,2,"DataOne",1,0,0,2
"dbar, decibar",0,0,0,0,0,0,2,"DataOne",1,0,0,2
"de",0,0,0,0,0,0,2,"DataOne",1,0,0,2
"decial degrees",0,0,0,0,0,0,2,"DataOne",1,0,0,2
"deciaml degrees",0,0,0,0,0,0,2,"DataOne",1,0,0,2
"decimal",0,0,0,0,0,0,2,"DataOne",1,0,0,2
"decimal degrees east",0,0,0,0,0,0,2,"DataOne",1,0,0,2
"decimal degrees referenced to the north american datum of 1927",0,0,0,0,0,0,2,"DataOne",1,0,0,2
"decimal degrees, wgs84",0,0,0,0,0,0,2,"DataOne",1,0,0,2
"decimal seconds",0,0,0,0,0,0,2,"DataOne",1,0,0,2
"decimal seconds",0,0,0,0,0,0,2,"DataOne",1,0,0,2
"decisiemenspermetre",0,0,0,0,0,0,2,"DataOne",1,0,0,2
"decmal degrees",0,0,0,0,0,0,2,"DataOne",1,0,0,2
"degrees c",0,0,0,0,0,0,2,"DataOne",1,0,0,2
"degrees decimal minutes",0,0,0,0,0,0,2,"DataOne",1,0,0,2
"degrees fahrenheit",0,0,0,0,0,0,2,"DataOne",1,0,0,2
"degrees from north",0,0,0,0,0,0,2,"DataOne",1,0,0,2
"degrees. attribute_meaurement_resolution is 0.000001",0,0,0,0,0,0,2,"DataOne",1,0,0,2
"degress latitude",0,0,0,0,0,0,2,"DataOne",1,0,0,2
"delta",0,0,0,0,0,0,2,"DataOne",1,0,0,2
"dem",0,0,0,0,0,0,2,"DataOne",1,0,0,2
"dense",0,0,0,0,0,0,2,"DataOne",1,0,0,2
"dense",0,0,0,0,0,0,2,"DataOne",1,0,0,2
"depth of sediment in cm",0,0,0,0,0,0,2,"DataOne",1,0,0,2
"dimensionless ratio",0,0,0,0,0,0,2,"DataOne",1,0,0,2
"diver",0,0,0,0,0,0,2,"DataOne",1,0,0,2
"diver grabs",0,0,0,0,0,0,2,"DataOne",1,0,0,2
"diver push core",0,0,0,0,0,0,2,"DataOne",1,0,0,2
"diver, hand",0,0,0,0,0,0,2,"DataOne",1,0,0,2
"divers, by hand",0,0,0,0,0,0,2,"DataOne",1,0,0,2
"dna",0,0,0,0,0,0,2,"DataOne",1,0,0,2
"dnq",0,0,0,0,0,0,2,"DataOne",1,0,0,2
"dominant",0,0,0,0,0,0,2,"DataOne",1,0,0,2
"door county wi",0,0,0,0,0,0,2,"DataOne",1,0,0,2
"dr1",0,0,0,0,0,0,2,"DataOne",1,0,0,2
"dr2",0,0,0,0,0,0,2,"DataOne",1,0,0,2
"dr3",0,0,0,0,0,0,2,"DataOne",1,0,0,2
"drill core",0,0,0,0,0,0,2,"DataOne",1,0,0,2
"drilled core",0,0,0,0,0,0,2,"DataOne",1,0,0,2
"dry",0,0,0,0,0,0,2,"DataOne",1,0,0,2
"dune",0,0,0,0,0,0,2,"DataOne",1,0,0,2
"dune",0,0,0,0,0,0,2,"DataOne",1,0,0,2
"e",0,0,0,0,0,0,2,"DataOne",1,0,0,2
"e i_cgs",0,0,0,0,0,0,2,"DataOne",1,0,0,2
"e_east",0,0,0,0,0,0,2,"DataOne",1,0,0,2
"e1",0,0,0,0,0,0,2,"DataOne",1,0,0,2
"e2",0,0,0,0,0,0,2,"DataOne",1,0,0,2
"east",0,0,0,0,0,0,2,"DataOne",1,0,0,2
"eastern up",0,0,0,0,0,0,2,"DataOne",1,0,0,2
"easting (meters), using wgs84 datum, utm zone 12n",0,0,0,0,0,0,2,"DataOne",1,0,0,2
"eb",0,0,0,0,0,0,2,"DataOne",1,0,0,2
"ebb tidal delta",0,0,0,0,0,0,2,"DataOne",1,0,0,2
"edt",0,0,0,0,0,0,2,"DataOne",1,0,0,2
"eh",0,0,0,0,0,0,2,"DataOne",1,0,0,2
"ek, mw, km",0,0,0,0,0,0,2,"DataOne",1,0,0,2
"electron_microprobe_provenance_diagram",0,0,0,0,0,0,2,"DataOne",1,0,0,2
"electron_microprobe_provenance_diagrams_field_boundaries",0,0,0,0,0,0,2,"DataOne",1,0,0,2
"electron_microprobe_provenance_figure_field_boundaries",0,0,0,0,0,0,2,"DataOne",1,0,0,2
"electron_microprobe_provenance_figures",0,0,0,0,0,0,2,"DataOne",1,0,0,2
"ema",0,0,0,0,0,0,2,"DataOne",1,0,0,2
"emb",0,0,0,0,0,0,2,"DataOne",1,0,0,2
"emc",0,0,0,0,0,0,2,"DataOne",1,0,0,2
"emd",0,0,0,0,0,0,2,"DataOne",1,0,0,2
"erosion",0,0,0,0,0,0,2,"DataOne",1,0,0,2
"es",0,0,0,0,0,0,2,"DataOne",1,0,0,2
"es_sq",0,0,0,0,0,0,2,"DataOne",1,0,0,2
"è™•ç†ç­‰ç´š",0,0,0,0,0,0,2,"DataOne",1,0,0,2
"everglades",0,0,0,0,0,0,2,"DataOne",1,0,0,2
"exit creek",0,0,0,0,0,0,2,"DataOne",1,0,0,2
"expanded_vermiculites_box_and_wisker_diagram",0,0,0,0,0,0,2,"DataOne",1,0,0,2
"expanded_vermiculites_box_and_wisker_figures",0,0,0,0,0,0,2,"DataOne",1,0,0,2
"expanded_vermiculites_provenance_diagram",0,0,0,0,0,0,2,"DataOne",1,0,0,2
"expanded_vermiculites_provenance_figures",0,0,0,0,0,0,2,"DataOne",1,0,0,2
"f",0,0,0,0,0,0,2,"DataOne",1,0,0,2
"f i_cgs / pcbg",0,0,0,0,0,0,2,"DataOne",1,0,0,2
"f1",0,0,0,0,0,0,2,"DataOne",1,0,0,2
"f2",0,0,0,0,0,0,2,"DataOne",1,0,0,2
"fa_ms",0,0,0,0,0,0,2,"DataOne",1,0,0,2
"far",0,0,0,0,0,0,2,"DataOne",1,0,0,2
"farnella",0,0,0,0,0,0,2,"DataOne",1,0,0,2
"fb",0,0,0,0,0,0,2,"DataOne",1,0,0,2
"feet above the north american vertical datum 1988",0,0,0,0,0,0,2,"DataOne",1,0,0,2
"feet. attribute_meaurement_resolution is 1",0,0,0,0,0,0,2,"DataOne",1,0,0,2
"fine pebbles",0,0,0,0,0,0,2,"DataOne",1,0,0,2
"fine sand",0,0,0,0,0,0,2,"DataOne",1,0,0,2
"flat brook (nj)",0,0,0,0,0,0,2,"DataOne",1,0,0,2
"fork",0,0,0,0,0,0,2,"DataOne",1,0,0,2
"fosp",0,0,0,0,0,0,2,"DataOne",1,0,0,2
"fox creek",0,0,0,0,0,0,2,"DataOne",1,0,0,2
"frequency",0,0,0,0,0,0,2,"DataOne",1,0,0,2
"fs",0,0,0,0,0,0,2,"DataOne",1,0,0,2
"ft, feet, gpm, gallons per minute",0,0,0,0,0,0,2,"DataOne",1,0,0,2
"fum.",0,0,0,0,0,0,2,"DataOne",1,0,0,2
"fvef",0,0,0,0,0,0,2,"DataOne",1,0,0,2
"fvr ungaged",0,0,0,0,0,0,2,"DataOne",1,0,0,2
"g c/m2/hour",0,0,0,0,0,0,2,"DataOne",1,0,0,2
"g/dl",0,0,0,0,0,0,2,"DataOne",1,0,0,2
"g/kg, grams per kilogram",0,0,0,0,0,0,2,"DataOne",1,0,0,2
"g1",0,0,0,0,0,0,2,"DataOne",1,0,0,2
"g1 i_mfgs",0,0,0,0,0,0,2,"DataOne",1,0,0,2
"g2",0,0,0,0,0,0,2,"DataOne",1,0,0,2
"g2 i_mfgs",0,0,0,0,0,0,2,"DataOne",1,0,0,2
"gcsp",0,0,0,0,0,0,2,"DataOne",1,0,0,2
"gcth",0,0,0,0,0,0,2,"DataOne",1,0,0,2
"gently-sloping shelf",0,0,0,0,0,0,2,"DataOne",1,0,0,2
"gfdl a2 climate + ctu",0,0,0,0,0,0,2,"DataOne",1,0,0,2
"gfdl a2 climate + ctu + cvjvgoalwr",0,0,0,0,0,0,2,"DataOne",1,0,0,2
"gfdl a2 climate + ctu + cvjvgoalwr + cawaterfix",0,0,0,0,0,0,2,"DataOne",1,0,0,2
"gfdl a2 climate + ctu + cvjvgoalwr + crop habitat priority reduction",0,0,0,0,0,0,2,"DataOne",1,0,0,2
"gfdl a2 climate + ctu + cvjvgoalwr + habitat priority reduction + cawaterfix",0,0,0,0,0,0,2,"DataOne",1,0,0,2
"gfdl a2 climate + ctu + cvjvgoalwr + wetland habitat priority reduction",0,0,0,0,0,0,2,"DataOne",1,0,0,2
"gfdl a2 climate + eu",0,0,0,0,0,0,2,"DataOne",1,0,0,2
"gfdl a2 climate + eu + cvjvgoalwr",0,0,0,0,0,0,2,"DataOne",1,0,0,2
"gi",0,0,0,0,0,0,2,"DataOne",1,0,0,2
"glaciolacustrine",0,0,0,0,0,0,2,"DataOne",1,0,0,2
"gld",0,0,0,0,0,0,2,"DataOne",1,0,0,2
"glgu",0,0,0,0,0,0,2,"DataOne",1,0,0,2
"good",0,0,0,0,0,0,2,"DataOne",1,0,0,2
"gp",0,0,0,0,0,0,2,"DataOne",1,0,0,2
"gp1",0,0,0,0,0,0,2,"DataOne",1,0,0,2
"gp2",0,0,0,0,0,0,2,"DataOne",1,0,0,2
"grab sample",0,0,0,0,0,0,2,"DataOne",1,0,0,2
"grams per cell (g/cell)",0,0,0,0,0,0,2,"DataOne",1,0,0,2
"grams per liter",0,0,0,0,0,0,2,"DataOne",1,0,0,2
"grant creek",0,0,0,0,0,0,2,"DataOne",1,0,0,2
"granules",0,0,0,0,0,0,2,"DataOne",1,0,0,2
"gravelley sediment",0,0,0,0,0,0,2,"DataOne",1,0,0,2
"gravelly sediment",0,0,0,0,0,0,2,"DataOne",1,0,0,2
"grja",0,0,0,0,0,0,2,"DataOne",1,0,0,2
"gw",0,0,0,0,0,0,2,"DataOne",1,0,0,2
"gwfg",0,0,0,0,0,0,2,"DataOne",1,0,0,2
"h",0,0,0,0,0,0,2,"DataOne",1,0,0,2
"h2",0,0,0,0,0,0,2,"DataOne",1,0,0,2
"hand",0,0,0,0,0,0,2,"DataOne",1,0,0,2
"hard-bottom plains",0,0,0,0,0,0,2,"DataOne",1,0,0,2
"herbaceous",0,0,0,0,0,0,2,"DataOne",1,0,0,2
"herbaceous",0,0,0,0,0,0,2,"DataOne",1,0,0,2
"hi",0,0,0,0,0,0,2,"DataOne",1,0,0,2
"highbkstr",0,0,0,0,0,0,2,"DataOne",1,0,0,2
"historical climate + no urbanization",0,0,0,0,0,0,2,"DataOne",1,0,0,2
"hola",0,0,0,0,0,0,2,"DataOne",1,0,0,2
"hore",0,0,0,0,0,0,2,"DataOne",1,0,0,2
"hour (24-hr: utc)",0,0,0,0,0,0,2,"DataOne",1,0,0,2
"hours of 24-hour day",0,0,0,0,0,0,2,"DataOne",1,0,0,2
"humpback whitefish",0,0,0,0,0,0,2,"DataOne",1,0,0,2
"i",0,0,0,0,0,0,2,"DataOne",1,0,0,2
"ia",0,0,0,0,0,0,2,"DataOne",1,0,0,2
"il",0,0,0,0,0,0,2,"DataOne",1,0,0,2
"imong",0,0,0,0,0,0,2,"DataOne",1,0,0,2
"impacted",0,0,0,0,0,0,2,"DataOne",1,0,0,2
"in",0,0,0,0,0,0,2,"DataOne",1,0,0,2
"inches",0,0,0,0,0,0,2,"DataOne",1,0,0,2
"index value",0,0,0,0,0,0,2,"DataOne",1,0,0,2
"individual",0,0,0,0,0,0,2,"DataOne",1,0,0,2
"intense",0,0,0,0,0,0,2,"DataOne",1,0,0,2
"ise",0,0,0,0,0,0,2,"DataOne",1,0,0,2
"ise_fuse",0,0,0,0,0,0,2,"DataOne",1,0,0,2
"ise_hf",0,0,0,0,0,0,2,"DataOne",1,0,0,2
"j",0,0,0,0,0,0,2,"DataOne",1,0,0,2
"juvenile tailed frog (jtf) 10",0,0,0,0,0,0,2,"DataOne",1,0,0,2
"kcal",0,0,0,0,0,0,2,"DataOne",1,0,0,2
"kcals",0,0,0,0,0,0,2,"DataOne",1,0,0,2
"kg/ha",0,0,0,0,0,0,2,"DataOne",1,0,0,2
"kg/m3, kilograms per cubic meter",0,0,0,0,0,0,2,"DataOne",1,0,0,2
"km, mw",0,0,0,0,0,0,2,"DataOne",1,0,0,2
"ks",0,0,0,0,0,0,2,"DataOne",1,0,0,2
"kws-4",0,0,0,0,0,0,2,"DataOne",1,0,0,2
"kws-6",0,0,0,0,0,0,2,"DataOne",1,0,0,2
"ky",0,0,0,0,0,0,2,"DataOne",1,0,0,2
"l0",0,0,0,0,0,0,2,"DataOne",1,0,0,2
"l1",0,0,0,0,0,0,2,"DataOne",1,0,0,2
"l2",0,0,0,0,0,0,2,"DataOne",1,0,0,2
"l3",0,0,0,0,0,0,2,"DataOne",1,0,0,2
"lalo",0,0,0,0,0,0,2,"DataOne",1,0,0,2
"land",0,0,0,0,0,0,2,"DataOne",1,0,0,2
"land",0,0,0,0,0,0,2,"DataOne",1,0,0,2
"least cisco",0,0,0,0,0,0,2,"DataOne",1,0,0,2
"lnd",0,0,0,0,0,0,2,"DataOne",1,0,0,2
"log cubic meters per square kilometer",0,0,0,0,0,0,2,"DataOne",1,0,0,2
"log of acre-feet",0,0,0,0,0,0,2,"DataOne",1,0,0,2
"log of people per square kilometer",0,0,0,0,0,0,2,"DataOne",1,0,0,2
"logbook",0,0,0,0,0,0,2,"DataOne",1,0,0,2
"lonic",0,0,0,0,0,0,2,"DataOne",1,0,0,2
"louisiana",0,0,0,0,0,0,2,"DataOne",1,0,0,2
"lowbkstr",0,0,0,0,0,0,2,"DataOne",1,0,0,2
"lower",0,0,0,0,0,0,2,"DataOne",1,0,0,2
"ltja",0,0,0,0,0,0,2,"DataOne",1,0,0,2
"lz",0,0,0,0,0,0,2,"DataOne",1,0,0,2
"m3/d",0,0,0,0,0,0,2,"DataOne",1,0,0,2
"ma",0,0,0,0,0,0,2,"DataOne",1,0,0,2
"mab (meters above bed)",0,0,0,0,0,0,2,"DataOne",1,0,0,2
"mall",0,0,0,0,0,0,2,"DataOne",1,0,0,2
"marsh fresh",0,0,0,0,0,0,2,"DataOne",1,0,0,2
"maulap",0,0,0,0,0,0,2,"DataOne",1,0,0,2
"mckinney70",0,0,0,0,0,0,2,"DataOne",1,0,0,2
"md",0,0,0,0,0,0,2,"DataOne",1,0,0,2
"mdt",0,0,0,0,0,0,2,"DataOne",1,0,0,2
"me",0,0,0,0,0,0,2,"DataOne",1,0,0,2
"medium",0,0,0,0,0,0,2,"DataOne",1,0,0,2
"medium-high",0,0,0,0,0,0,2,"DataOne",1,0,0,2
"medium pebbles",0,0,0,0,0,0,2,"DataOne",1,0,0,2
"megajoulepersquaremeter",0,0,0,0,0,0,2,"DataOne",1,0,0,2
"megajoules/metersquared",0,0,0,0,0,0,2,"DataOne",1,0,0,2
"megaripples/sand waves",0,0,0,0,0,0,2,"DataOne",1,0,0,2
"merl",0,0,0,0,0,0,2,"DataOne",1,0,0,2
"message",0,0,0,0,0,0,2,"DataOne",1,0,0,2
"meters above the north american vertical datum of 1988",0,0,0,0,0,0,2,"DataOne",1,0,0,2
"meters below mean lower low water",0,0,0,0,0,0,2,"DataOne",1,0,0,2
"metric tons of copper",0,0,0,0,0,0,2,"DataOne",1,0,0,2
"mg hc/g toc",0,0,0,0,0,0,2,"DataOne",1,0,0,2
"mgl-1",0,0,0,0,0,0,2,"DataOne",1,0,0,2
"mi",0,0,0,0,0,0,2,"DataOne",1,0,0,2
"microe m-2 s-1",0,0,0,0,0,0,2,"DataOne",1,0,0,2
"micrograms per kilogram",0,0,0,0,0,0,2,"DataOne",1,0,0,2
"micrograms per liter (ug/l)",0,0,0,0,0,0,2,"DataOne",1,0,0,2
"micrograms/liter",0,0,0,0,0,0,2,"DataOne",1,0,0,2
"micromol/kg",0,0,0,0,0,0,2,"DataOne",1,0,0,2
"micromolar (micromolar)",0,0,0,0,0,0,2,"DataOne",1,0,0,2
"micromole per kilogram of water (umol/kg)",0,0,0,0,0,0,2,"DataOne",1,0,0,2
"microsiemens / centimeter (us/cm)",0,0,0,0,0,0,2,"DataOne",1,0,0,2
"middle",0,0,0,0,0,0,2,"DataOne",1,0,0,2
"military time",0,0,0,0,0,0,2,"DataOne",1,0,0,2
"milli-siemens per centimeter",0,0,0,0,0,0,2,"DataOne",1,0,0,2
"milligramperlitte",0,0,0,0,0,0,2,"DataOne",1,0,0,2
"milligrams per gram oil (mg/g oil)",0,0,0,0,0,0,2,"DataOne",1,0,0,2
"milligrams per kilogram (mg/kg), wet weight",0,0,0,0,0,0,2,"DataOne",1,0,0,2
"milligrams per liter  (mg/l)",0,0,0,0,0,0,2,"DataOne",1,0,0,2
"milligrams per liter as calcium carbonate (mg/l as caco3)",0,0,0,0,0,0,2,"DataOne",1,0,0,2
"milligrams per liter as phosphorus (mg/l as p)",0,0,0,0,0,0,2,"DataOne",1,0,0,2
"milligramsperhectare",0,0,0,0,0,0,2,"DataOne",1,0,0,2
"millimeters mercury",0,0,0,0,0,0,2,"DataOne",1,0,0,2
"millimetresperhour",0,0,0,0,0,0,2,"DataOne",1,0,0,2
"million gallons per day per square mile",0,0,0,0,0,0,2,"DataOne",1,0,0,2
"millions of barrels (mbls)",0,0,0,0,0,0,2,"DataOne",1,0,0,2
"millisiemens per centimeter",0,0,0,0,0,0,2,"DataOne",1,0,0,2
"millivolts (mv)",0,0,0,0,0,0,2,"DataOne",1,0,0,2
"min. van veen",0,0,0,0,0,0,2,"DataOne",1,0,0,2
"mini-seaboss",0,0,0,0,0,0,2,"DataOne",1,0,0,2
"minute (24-hr clock, utc)",0,0,0,0,0,0,2,"DataOne",1,0,0,2
"missing",0,0,0,0,0,0,2,"DataOne",1,0,0,2
"mn",0,0,0,0,0,0,2,"DataOne",1,0,0,2
"mo",0,0,0,0,0,0,2,"DataOne",1,0,0,2
"modbkstr",0,0,0,0,0,0,2,"DataOne",1,0,0,2
"moderate",0,0,0,0,0,0,2,"DataOne",1,0,0,2
"moderately-sloping shelf",0,0,0,0,0,0,2,"DataOne",1,0,0,2
"mog data",0,0,0,0,0,0,2,"DataOne",1,0,0,2
"moist",0,0,0,0,0,0,2,"DataOne",1,0,0,2
"month/day/year",0,0,0,0,0,0,2,"DataOne",1,0,0,2
"mouth",0,0,0,0,0,0,2,"DataOne",1,0,0,2
"ms/m",0,0,0,0,0,0,2,"DataOne",1,0,0,2
"ms_st",0,0,0,0,0,0,2,"DataOne",1,0,0,2
"ms_st_ree",0,0,0,0,0,0,2,"DataOne",1,0,0,2
"mspr-04",0,0,0,0,0,0,2,"DataOne",1,0,0,2
"mt",0,0,0,0,0,0,2,"DataOne",1,0,0,2
"mts",0,0,0,0,0,0,2,"DataOne",1,0,0,2
"mud flat fresh",0,0,0,0,0,0,2,"DataOne",1,0,0,2
"mudpeat",0,0,0,0,0,0,2,"DataOne",1,0,0,2
"muscle",0,0,0,0,0,0,2,"DataOne",1,0,0,2
"mw, km",0,0,0,0,0,0,2,"DataOne",1,0,0,2
"n",0,0,0,0,0,0,2,"DataOne",1,0,0,2
"n. american river",0,0,0,0,0,0,2,"DataOne",1,0,0,2
"na_lc",0,0,0,0,0,0,2,"DataOne",1,0,0,2
"na_sc",0,0,0,0,0,0,2,"DataOne",1,0,0,2
"nad27",0,0,0,0,0,0,2,"DataOne",1,0,0,2
"nan",0,0,0,0,0,0,2,"DataOne",1,0,0,2
"nanograms per liter",0,0,0,0,0,0,2,"DataOne",1,0,0,2
"nanomolar (nm)",0,0,0,0,0,0,2,"DataOne",1,0,0,2
"nanoteslas (nt)",0,0,0,0,0,0,2,"DataOne",1,0,0,2
"nc",0,0,0,0,0,0,2,"DataOne",1,0,0,2
"near",0,0,0,0,0,0,2,"DataOne",1,0,0,2
"nech80-1",0,0,0,0,0,0,2,"DataOne",1,0,0,2
"nh",0,0,0,0,0,0,2,"DataOne",1,0,0,2
"nj",0,0,0,0,0,0,2,"DataOne",1,0,0,2
"nm",0,0,0,0,0,0,2,"DataOne",1,0,0,2
"non dimensional",0,0,0,0,0,0,2,"DataOne",1,0,0,2
"nopi",0,0,0,0,0,0,2,"DataOne",1,0,0,2
"northern pike",0,0,0,0,0,0,2,"DataOne",1,0,0,2
"northing (meters), using wgs84 datum, utm zone 12n",0,0,0,0,0,0,2,"DataOne",1,0,0,2
"nowa",0,0,0,0,0,0,2,"DataOne",1,0,0,2
"nowh",0,0,0,0,0,0,2,"DataOne",1,0,0,2
"np",0,0,0,0,0,0,2,"DataOne",1,0,0,2
"ns",0,0,0,0,0,0,2,"DataOne",1,0,0,2
"number of elapsed hours",0,0,0,0,0,0,2,"DataOne",1,0,0,2
"number of individuals",0,0,0,0,0,0,2,"DataOne",1,0,0,2
"number of passes/locations",0,0,0,0,0,0,2,"DataOne",1,0,0,2
"number of samples collected",0,0,0,0,0,0,2,"DataOne",1,0,0,2
"number plausible checks",0,0,0,0,0,0,2,"DataOne",1,0,0,2
"numberperkilometerofshoreline",0,0,0,0,0,0,2,"DataOne",1,0,0,2
"nv",0,0,0,0,0,0,2,"DataOne",1,0,0,2
"nwis",0,0,0,0,0,0,2,"DataOne",1,0,0,2
"ny",0,0,0,0,0,0,2,"DataOne",1,0,0,2
"ny bight",0,0,0,0,0,0,2,"DataOne",1,0,0,2
"ob",0,0,0,0,0,0,2,"DataOne",1,0,0,2
"oh",0,0,0,0,0,0,2,"DataOne",1,0,0,2
"oncorhynchus mykiss",0,0,0,0,0,0,2,"DataOne",1,0,0,2
"open water fresh",0,0,0,0,0,0,2,"DataOne",1,0,0,2
"or",0,0,0,0,0,0,2,"DataOne",1,0,0,2
"oregon",0,0,0,0,0,0,2,"DataOne",1,0,0,2
"other winter-flooded cropland",0,0,0,0,0,0,2,"DataOne",1,0,0,2
"output as a word-based description that may involve numerics. this field will need to be selected against when gis mappings of the bulk sedient characters are being mapped. only blank entries should be included in such a mapping.",0,0,0,0,0,0,2,"DataOne",1,0,0,2
"p8n",0,0,0,0,0,0,2,"DataOne",1,0,0,2
"p8s",0,0,0,0,0,0,2,"DataOne",1,0,0,2
"p9n",0,0,0,0,0,0,2,"DataOne",1,0,0,2
"p9s",0,0,0,0,0,0,2,"DataOne",1,0,0,2
"pa",0,0,0,0,0,0,2,"DataOne",1,0,0,2
"pagp",0,0,0,0,0,0,2,"DataOne",1,0,0,2
"paradise creek",0,0,0,0,0,0,2,"DataOne",1,0,0,2
"parts per trillion (ppt)",0,0,0,0,0,0,2,"DataOne",1,0,0,2
"partsperthousand",0,0,0,0,0,0,2,"DataOne",1,0,0,2
"pci/l",0,0,0,0,0,0,2,"DataOne",1,0,0,2
"pcm1 b1 climate + ctu",0,0,0,0,0,0,2,"DataOne",1,0,0,2
"pcm1 b1 climate + ctu + cvjvgoalwr",0,0,0,0,0,0,2,"DataOne",1,0,0,2
"pcm1 b1 climate + ctu + cvjvgoalwr + cawaterfix",0,0,0,0,0,0,2,"DataOne",1,0,0,2
"pcm1 b1 climate + ctu + cvjvgoalwr + crop habitat priority reduction",0,0,0,0,0,0,2,"DataOne",1,0,0,2
"pcm1 b1 climate + ctu + cvjvgoalwr + habitat priority reduction + cawaterfix",0,0,0,0,0,0,2,"DataOne",1,0,0,2
"pcm1 b1 climate + ctu + cvjvgoalwr + wetland habitat priority reduction",0,0,0,0,0,0,2,"DataOne",1,0,0,2
"pcm1 b1 climate + su",0,0,0,0,0,0,2,"DataOne",1,0,0,2
"pcm1 b1 climate + su + cvjvgoalwr",0,0,0,0,0,0,2,"DataOne",1,0,0,2
"pef",0,0,0,0,0,0,2,"DataOne",1,0,0,2
"percent carbon",0,0,0,0,0,0,2,"DataOne",1,0,0,2
"percent nitrogen",0,0,0,0,0,0,2,"DataOne",1,0,0,2
"percent out of 100",0,0,0,0,0,0,2,"DataOne",1,0,0,2
"peterson grab",0,0,0,0,0,0,2,"DataOne",1,0,0,2
"phunit",0,0,0,0,0,0,2,"DataOne",1,0,0,2
"picomolesperminutepermilligramofprotein",0,0,0,0,0,0,2,"DataOne",1,0,0,2
"piston sampler (hydraulic)",0,0,0,0,0,0,2,"DataOne",1,0,0,2
"pits",0,0,0,0,0,0,2,"DataOne",1,0,0,2
"point number",0,0,0,0,0,0,2,"DataOne",1,0,0,2
"pollen_quantity",0,0,0,0,0,0,2,"DataOne",1,0,0,2
"ponar grab",0,0,0,0,0,0,2,"DataOne",1,0,0,2
"pond",0,0,0,0,0,0,2,"DataOne",1,0,0,2
"pool_g",0,0,0,0,0,0,2,"DataOne",1,0,0,2
"pos",0,0,0,0,0,0,2,"DataOne",1,0,0,2
"position",0,0,0,0,0,0,2,"DataOne",1,0,0,2
"positive number, no data = blank",0,0,0,0,0,0,2,"DataOne",1,0,0,2
"ppm/hour",0,0,0,0,0,0,2,"DataOne",1,0,0,2
"present",0,0,0,0,0,0,2,"DataOne",1,0,0,2
"producer defined",0,0,0,0,0,0,2,"DataOne",1,0,0,2
"ps",0,0,0,0,0,0,2,"DataOne",1,0,0,2
"pugetsound",0,0,0,0,0,0,2,"DataOne",1,0,0,2
"qsc",0,0,0,0,0,0,2,"DataOne",1,0,0,2
"querc",0,0,0,0,0,0,2,"DataOne",1,0,0,2
"rafa09059",0,0,0,0,0,0,2,"DataOne",1,0,0,2
"rainbow smelt",0,0,0,0,0,0,2,"DataOne",1,0,0,2
"rcki",0,0,0,0,0,0,2,"DataOne",1,0,0,2
"record",0,0,0,0,0,0,2,"DataOne",1,0,0,2
"referenced",0,0,0,0,0,0,2,"DataOne",1,0,0,2
"removed",0,0,0,0,0,0,2,"DataOne",1,0,0,2
"ri",0,0,0,0,0,0,2,"DataOne",1,0,0,2
"ridgeswale",0,0,0,0,0,0,2,"DataOne",1,0,0,2
"rlha",0,0,0,0,0,0,2,"DataOne",1,0,0,2
"rocky",0,0,0,0,0,0,2,"DataOne",1,0,0,2
"ropt",0,0,0,0,0,0,2,"DataOne",1,0,0,2
"roq",0,0,0,0,0,0,2,"DataOne",1,0,0,2
"rotosonic core",0,0,0,0,0,0,2,"DataOne",1,0,0,2
"rss",0,0,0,0,0,0,2,"DataOne",1,0,0,2
"s.g.",0,0,0,0,0,0,2,"DataOne",1,0,0,2
"s99",0,0,0,0,0,0,2,"DataOne",1,0,0,2
"sacr",0,0,0,0,0,0,2,"DataOne",1,0,0,2
"san joaquin",0,0,0,0,0,0,2,"DataOne",1,0,0,2
"sand ridge or bedform",0,0,0,0,0,0,2,"DataOne",1,0,0,2
"sand waves",0,0,0,0,0,0,2,"DataOne",1,0,0,2
"sand waves and megaripples",0,0,0,0,0,0,2,"DataOne",1,0,0,2
"sandy",0,0,0,0,0,0,2,"DataOne",1,0,0,2
"sandy gravel",0,0,0,0,0,0,2,"DataOne",1,0,0,2
"savs",0,0,0,0,0,0,2,"DataOne",1,0,0,2
"sb",0,0,0,0,0,0,2,"DataOne",1,0,0,2
"sc",0,0,0,0,0,0,2,"DataOne",1,0,0,2
"scarp",0,0,0,0,0,0,2,"DataOne",1,0,0,2
"scenario",0,0,0,0,0,0,2,"DataOne",1,0,0,2
"scenario",0,0,0,0,0,0,2,"DataOne",1,0,0,2
"seasonal wetland (not summer irrigated)",0,0,0,0,0,0,2,"DataOne",1,0,0,2
"seasonal wetland (summer-irrigated)",0,0,0,0,0,0,2,"DataOne",1,0,0,2
"second (24-hr clock, utc)",0,0,0,0,0,0,2,"DataOne",1,0,0,2
"seep",0,0,0,0,0,0,2,"DataOne",1,0,0,2
"seismic line identification",0,0,0,0,0,0,2,"DataOne",1,0,0,2
"seismic shot",0,0,0,0,0,0,2,"DataOne",1,0,0,2
"sequential count",0,0,0,0,0,0,2,"DataOne",1,0,0,2
"serial number",0,0,0,0,0,0,2,"DataOne",1,0,0,2
"sfbay",0,0,0,0,0,0,2,"DataOne",1,0,0,2
"shelf valley",0,0,0,0,0,0,2,"DataOne",1,0,0,2
"shell beds",0,0,0,0,0,0,2,"DataOne",1,0,0,2
"shellgravelcobble",0,0,0,0,0,0,2,"DataOne",1,0,0,2
"shg",0,0,0,0,0,0,2,"DataOne",1,0,0,2
"ship wreck",0,0,0,0,0,0,2,"DataOne",1,0,0,2
"short ton (namely, 2000 pounds avoirdupois)",0,0,0,0,0,0,2,"DataOne",1,0,0,2
"shrub",0,0,0,0,0,0,2,"DataOne",1,0,0,2
"silt",0,0,0,0,0,0,2,"DataOne",1,0,0,2
"silty sand",0,0,0,0,0,0,2,"DataOne",1,0,0,2
"site names given in alphabetical order.",0,0,0,0,0,0,2,"DataOne",1,0,0,2
"sleeping bear dunes nl",0,0,0,0,0,0,2,"DataOne",1,0,0,2
"slimy sculpin",0,0,0,0,0,0,2,"DataOne",1,0,0,2
"smith-mcintyre w/camera",0,0,0,0,0,0,2,"DataOne",1,0,0,2
"smith-mcintyre w/ocamera",0,0,0,0,0,0,2,"DataOne",1,0,0,2
"smm",0,0,0,0,0,0,2,"DataOne",1,0,0,2
"solid",0,0,0,0,0,0,2,"DataOne",1,0,0,2
"sort_rework",0,0,0,0,0,0,2,"DataOne",1,0,0,2
"sort_rework",0,0,0,0,0,0,2,"DataOne",1,0,0,2
"sorting",0,0,0,0,0,0,2,"DataOne",1,0,0,2
"sorting or reworking",0,0,0,0,0,0,2,"DataOne",1,0,0,2
"sparse",0,0,0,0,0,0,2,"DataOne",1,0,0,2
"sparse",0,0,0,0,0,0,2,"DataOne",1,0,0,2
"spd",0,0,0,0,0,0,2,"DataOne",1,0,0,2
"square kilometers",0,0,0,0,0,0,2,"DataOne",1,0,0,2
"square meters",0,0,0,0,0,0,2,"DataOne",1,0,0,2
"square miles",0,0,0,0,0,0,2,"DataOne",1,0,0,2
"src",0,0,0,0,0,0,2,"DataOne",1,0,0,2
"ssw",0,0,0,0,0,0,2,"DataOne",1,0,0,2
"st",0,0,0,0,0,0,2,"DataOne",1,0,0,2
"st1",0,0,0,0,0,0,2,"DataOne",1,0,0,2
"standard deviations",0,0,0,0,0,0,2,"DataOne",1,0,0,2
"structure",0,0,0,0,0,0,2,"DataOne",1,0,0,2
"sub-surface mooring",0,0,0,0,0,0,2,"DataOne",1,0,0,2
"submerged aquatics fresh",0,0,0,0,0,0,2,"DataOne",1,0,0,2
"submersible arm grab",0,0,0,0,0,0,2,"DataOne",1,0,0,2
"surf",0,0,0,0,0,0,2,"DataOne",1,0,0,2
"survey h12296 in northern block island sound",0,0,0,0,0,0,2,"DataOne",1,0,0,2
"survey h12299",0,0,0,0,0,0,2,"DataOne",1,0,0,2
"sutter",0,0,0,0,0,0,2,"DataOne",1,0,0,2
"suva_254nm",0,0,0,0,0,0,2,"DataOne",1,0,0,2
"sva",0,0,0,0,0,0,2,"DataOne",1,0,0,2
"svb",0,0,0,0,0,0,2,"DataOne",1,0,0,2
"svc",0,0,0,0,0,0,2,"DataOne",1,0,0,2
"svd",0,0,0,0,0,0,2,"DataOne",1,0,0,2
"swab",0,0,0,0,0,0,2,"DataOne",1,0,0,2
"sz",0,0,0,0,0,0,2,"DataOne",1,0,0,2
"t-5",0,0,0,0,0,0,2,"DataOne",1,0,0,2
"t-7",0,0,0,0,0,0,2,"DataOne",1,0,0,2
"teflon shovel",0,0,0,0,0,0,2,"DataOne",1,0,0,2
"text value",0,0,0,0,0,0,2,"DataOne",1,0,0,2
"text values",0,0,0,0,0,0,2,"DataOne",1,0,0,2
"the day on which video was taken",0,0,0,0,0,0,2,"DataOne",1,0,0,2
"the hour in which video was taken",0,0,0,0,0,0,2,"DataOne",1,0,0,2
"the minute in which video position was taken",0,0,0,0,0,0,2,"DataOne",1,0,0,2
"the month in which video was taken",0,0,0,0,0,0,2,"DataOne",1,0,0,2
"the second in which video position was taken",0,0,0,0,0,0,2,"DataOne",1,0,0,2
"the wetlands conservancy",0,0,0,0,0,0,2,"DataOne",1,0,0,2
"tigard public works",0,0,0,0,0,0,2,"DataOne",1,0,0,2
"time_1",0,0,0,0,0,0,2,"DataOne",1,0,0,2
"time_2",0,0,0,0,0,0,2,"DataOne",1,0,0,2
"tm",0,0,0,0,0,0,2,"DataOne",1,0,0,2
"tn",0,0,0,0,0,0,2,"DataOne",1,0,0,2
"tob",0,0,0,0,0,0,2,"DataOne",1,0,0,2
"total",0,0,0,0,0,0,2,"DataOne",1,0,0,2
"transect identification number",0,0,0,0,0,0,2,"DataOne",1,0,0,2
"transmitter number",0,0,0,0,0,0,2,"DataOne",1,0,0,2
"tripod",0,0,0,0,0,0,2,"DataOne",1,0,0,2
"trowel",0,0,0,0,0,0,2,"DataOne",1,0,0,2
"tt_flux",0,0,0,0,0,0,2,"DataOne",1,0,0,2
"tt_hcl",0,0,0,0,0,0,2,"DataOne",1,0,0,2
"tt_hf",0,0,0,0,0,0,2,"DataOne",1,0,0,2
"tulare",0,0,0,0,0,0,2,"DataOne",1,0,0,2
"tusw",0,0,0,0,0,0,2,"DataOne",1,0,0,2
"tx",0,0,0,0,0,0,2,"DataOne",1,0,0,2
"u.s. fish and wildlife service",0,0,0,0,0,0,2,"DataOne",1,0,0,2
"ua1",0,0,0,0,0,0,2,"DataOne",1,0,0,2
"ua2",0,0,0,0,0,0,2,"DataOne",1,0,0,2
"ua3",0,0,0,0,0,0,2,"DataOne",1,0,0,2
"umol fe",0,0,0,0,0,0,2,"DataOne",1,0,0,2
"undetermined",0,0,0,0,0,0,2,"DataOne",1,0,0,2
"uninfected",0,0,0,0,0,0,2,"DataOne",1,0,0,2
"unknown",0,0,0,0,0,0,2,"DataOne",1,0,0,2
"upper",0,0,0,0,0,0,2,"DataOne",1,0,0,2
"usa",0,0,0,0,0,0,2,"DataOne",1,0,0,2
"usda",0,0,0,0,0,0,2,"DataOne",1,0,0,2
"usgs digital orthophoto",0,0,0,0,0,0,2,"DataOne",1,0,0,2
"ut beg",0,0,0,0,0,0,2,"DataOne",1,0,0,2
"utc.",0,0,0,0,0,0,2,"DataOne",1,0,0,2
"v",0,0,0,0,0,0,2,"DataOne",1,0,0,2
"va",0,0,0,0,0,0,2,"DataOne",1,0,0,2
"variable",0,0,0,0,0,0,2,"DataOne",1,0,0,2
"variable. measurement (and standard deviation) units for reported concentrations or activities for the constituents are provided in table01_constituents.xlsx.",0,0,0,0,0,0,2,"DataOne",1,0,0,2
"variable; see entry for record in accompanying field units",0,0,0,0,0,0,2,"DataOne",1,0,0,2
"vath",0,0,0,0,0,0,2,"DataOne",1,0,0,2
"very coarse pebbles",0,0,0,0,0,0,2,"DataOne",1,0,0,2
"very high",0,0,0,0,0,0,2,"DataOne",1,0,0,2
"very low",0,0,0,0,0,0,2,"DataOne",1,0,0,2
"very near",0,0,0,0,0,0,2,"DataOne",1,0,0,2
"very poor",0,0,0,0,0,0,2,"DataOne",1,0,0,2
"vfef",0,0,0,0,0,0,2,"DataOne",1,0,0,2
"vibra corer",0,0,0,0,0,0,2,"DataOne",1,0,0,2
"vibracorer",0,0,0,0,0,0,2,"DataOne",1,0,0,2
"volts 430",0,0,0,0,0,0,2,"DataOne",1,0,0,2
"vt",0,0,0,0,0,0,2,"DataOne",1,0,0,2
"washover",0,0,0,0,0,0,2,"DataOne",1,0,0,2
"washover",0,0,0,0,0,0,2,"DataOne",1,0,0,2
"watt hours/square meter/day",0,0,0,0,0,0,2,"DataOne",1,0,0,2
"watts per square meter",0,0,0,0,0,0,2,"DataOne",1,0,0,2
"watts per square metre",0,0,0,0,0,0,2,"DataOne",1,0,0,2
"wcsp",0,0,0,0,0,0,2,"DataOne",1,0,0,2
"wdx",0,0,0,0,0,0,2,"DataOne",1,0,0,2
"wdx_fuse",0,0,0,0,0,0,2,"DataOne",1,0,0,2
"well pads",0,0,0,0,0,0,2,"DataOne",1,0,0,2
"wesa",0,0,0,0,0,0,2,"DataOne",1,0,0,2
"west",0,0,0,0,0,0,2,"DataOne",1,0,0,2
"wet",0,0,0,0,0,0,2,"DataOne",1,0,0,2
"wet",0,0,0,0,0,0,2,"DataOne",1,0,0,2
"wet meadow shrub",0,0,0,0,0,0,2,"DataOne",1,0,0,2
"wetland forested",0,0,0,0,0,0,2,"DataOne",1,0,0,2
"wetland scrub shrub fresh",0,0,0,0,0,0,2,"DataOne",1,0,0,2
"whitefish spp.",0,0,0,0,0,0,2,"DataOne",1,0,0,2
"winter-flooded corn",0,0,0,0,0,0,2,"DataOne",1,0,0,2
"winter-flooded rice",0,0,0,0,0,0,2,"DataOne",1,0,0,2
"wipt",0,0,0,0,0,0,2,"DataOne",1,0,0,2
"wisn",0,0,0,0,0,0,2,"DataOne",1,0,0,2
"wms",0,0,0,0,0,0,2,"DataOne",1,0,0,2
"ws",0,0,0,0,0,0,2,"DataOne",1,0,0,2
"wv",0,0,0,0,0,0,2,"DataOne",1,0,0,2
"wy",0,0,0,0,0,0,2,"DataOne",1,0,0,2
"y",0,0,0,0,0,0,2,"DataOne",1,0,0,2
"year before present (yr bp)",0,0,0,0,0,0,2,"DataOne",1,0,0,2
"year.month",0,0,0,0,0,0,2,"DataOne",1,0,0,2
"years (yrs)",0,0,0,0,0,0,2,"DataOne",1,0,0,2
"ykd",0,0,0,0,0,0,2,"DataOne",1,0,0,2
"yolo",0,0,0,0,0,0,2,"DataOne",1,0,0,2
"yr bp",0,0,0,0,0,0,2,"DataOne",1,0,0,2
"yrwa",0,0,0,0,0,0,2,"DataOne",1,0,0,2
"ywar",0,0,0,0,0,0,2,"DataOne",1,0,0,2
"z",0,0,0,0,0,0,2,"DataOne",1,0,0,2
"zc",0,0,0,0,0,0,2,"DataOne",1,0,0,2
"zs",0,0,0,0,0,0,2,"DataOne",1,0,0,2
" micros.cm-2",1,1,1,0,0,0,0,"EDI",1,1,1,1
"
                micromolepermetersquaredpersecond",1,1,1,0,0,0,0,"EDI",1,1,1,1
"
                micromolepersquaremeterpersecond",1,1,1,0,0,0,0,"EDI",1,1,1,1
"
                millimeterpercentimetersquared",1,1,1,0,0,0,0,"EDI",1,1,1,1
"
                millimeterpercentimetersquaredperday",1,1,1,0,0,0,0,"EDI",1,1,1,1
"# / m^2 litter area",1,1,1,0,0,0,0,"EDI",1,1,1,1
"# diet categories",1,1,1,0,0,0,0,"EDI",1,1,1,1
"# of categories",1,1,1,0,0,0,0,"EDI",1,1,1,1
"#ofbacteria/hour/individual",1,1,1,0,0,0,0,"EDI",1,1,1,1
"#ofblackspruceperhectare",1,1,1,0,0,0,0,"EDI",1,1,1,1
"#x108/liter",1,1,1,0,0,0,0,"EDI",1,1,1,1
"% g water per g dry litter",1,1,1,0,0,0,0,"EDI",1,1,1,1
"%/day",1,1,1,0,0,0,0,"EDI",1,1,1,1
"%/ha",1,1,1,0,0,0,0,"EDI",1,1,1,1
"%h:%m:%s",1,1,1,0,0,0,0,"EDI",1,1,1,1
"%volumetricmoisturecontent",1,1,1,0,0,0,0,"EDI",1,1,1,1
"[ft_us]",1,1,1,0,0,0,0,"EDI",1,1,1,1
"µg cm-2",1,1,1,0,0,0,0,"EDI",1,1,1,1
"µg p/l",1,1,1,0,0,0,0,"EDI",1,1,1,1
"µm^3/m^2 litter ",1,1,1,0,0,0,0,"EDI",1,1,1,1
"absoptionpermolepercentimeter",1,1,1,0,0,0,0,"EDI",1,1,1,1
"abundance",1,1,1,0,0,0,0,"EDI",1,1,1,1
"acrefoot",1,1,1,0,0,0,0,"EDI",1,1,1,1
"adjusted day of year",1,1,1,0,0,0,0,"EDI",1,1,1,1
"animal-days",1,1,1,0,0,0,0,"EDI",1,1,1,1
"animal units",1,1,1,0,0,0,0,"EDI",1,1,1,1
"animalunitmonthperyear",1,1,1,0,0,0,0,"EDI",1,1,1,1
"area",1,1,1,0,0,0,0,"EDI",1,1,1,1
"average euclidean distance of each plot to the group (treatment or control) centriod in pcoa space",1,1,1,0,0,0,0,"EDI",1,1,1,1
"averagedcounts",1,1,1,0,0,0,0,"EDI",1,1,1,1
"ba/ha",1,1,1,0,0,0,0,"EDI",1,1,1,1
"becquerel",1,1,1,0,0,0,0,"EDI",1,1,1,1
"block",1,1,1,0,0,0,0,"EDI",1,1,1,1
"bushelperyear",1,1,1,0,0,0,0,"EDI",1,1,1,1
"catchpertrawl",1,1,1,0,0,0,0,"EDI",1,1,1,1
"cells / natural unit",1,1,1,0,0,0,0,"EDI",1,1,1,1
"cells per ml",1,1,1,0,0,0,0,"EDI",1,1,1,1
"cellspermililiter",1,1,1,0,0,0,0,"EDI",1,1,1,1
"cellspermillimetersquared",1,1,1,0,0,0,0,"EDI",1,1,1,1
"cellsperml",1,1,1,0,0,0,0,"EDI",1,1,1,1
"cellspersquaremillimeter",1,1,1,0,0,0,0,"EDI",1,1,1,1
"celsiuspermeter",1,1,1,0,0,0,0,"EDI",1,1,1,1
"celsiusperyear",1,1,1,0,0,0,0,"EDI",1,1,1,1
"cenimeterpermetersquaredperday",1,1,1,0,0,0,0,"EDI",1,1,1,1
"centiliterperliter",1,1,1,0,0,0,0,"EDI",1,1,1,1
"centimeterdepth",1,1,1,0,0,0,0,"EDI",1,1,1,1
"centimeterperday",1,1,1,0,0,0,0,"EDI",1,1,1,1
"centimeterperfiveminute",1,1,1,0,0,0,0,"EDI",1,1,1,1
"centimeterpergram",1,1,1,0,0,0,0,"EDI",1,1,1,1
"centimeterperhourperpascal",1,1,1,0,0,0,0,"EDI",1,1,1,1
"centimeterpermilligram",1,1,1,0,0,0,0,"EDI",1,1,1,1
"centimeterpersquarecentimeter",1,1,1,0,0,0,0,"EDI",1,1,1,1
"centimeterperyear",1,1,1,0,0,0,0,"EDI",1,1,1,1
"centimeters per hour",1,1,1,0,0,0,0,"EDI",1,1,1,1
"centimeterscubed",1,1,1,0,0,0,0,"EDI",1,1,1,1
"centimetersperhour",1,1,1,0,0,0,0,"EDI",1,1,1,1
"centimeterspersquaremeterperday",1,1,1,0,0,0,0,"EDI",1,1,1,1
"centimoleh+perkilogram",1,1,1,0,0,0,0,"EDI",1,1,1,1
"centimoles of charge per dry soil weight",1,1,1,0,0,0,0,"EDI",1,1,1,1
"centimolesofchargeperkilogram",1,1,1,0,0,0,0,"EDI",1,1,1,1
"cm amsl navd 88",1,1,1,0,0,0,0,"EDI",1,1,1,1
"cm^2/g",1,1,1,0,0,0,0,"EDI",1,1,1,1
"cm2 / g",1,1,1,0,0,0,0,"EDI",1,1,1,1
"cm2/4m2",1,1,1,0,0,0,0,"EDI",1,1,1,1
"coordinate",1,1,1,0,0,0,0,"EDI",1,1,1,1
"cordperacre",1,1,1,0,0,0,0,"EDI",1,1,1,1
"count (unitless)",1,1,1,0,0,0,0,"EDI",1,1,1,1
"count of specimens",1,1,1,0,0,0,0,"EDI",1,1,1,1
"count per m2",1,1,1,0,0,0,0,"EDI",1,1,1,1
"countper100squaremeters",1,1,1,0,0,0,0,"EDI",1,1,1,1
"countperquartermetersquared",1,1,1,0,0,0,0,"EDI",1,1,1,1
"cu m/hour",1,1,1,0,0,0,0,"EDI",1,1,1,1
"cubic meters per cubic meter",1,1,1,0,0,0,0,"EDI",1,1,1,1
"cubic micrometers per milliliter",1,1,1,0,0,0,0,"EDI",1,1,1,1
"cubicm*10^6",1,1,1,0,0,0,0,"EDI",1,1,1,1
"cubicmeterpersecond",1,1,1,0,0,0,0,"EDI",1,1,1,1
"cubicmeters",1,1,1,0,0,0,0,"EDI",1,1,1,1
"cubicmetersperhectare",1,1,1,0,0,0,0,"EDI",1,1,1,1
"cubicmicronpermilliliter",1,1,1,0,0,0,0,"EDI",1,1,1,1
"dalton",1,1,1,0,0,0,0,"EDI",1,1,1,1
"date code",1,1,1,0,0,0,0,"EDI",1,1,1,1
"date expressed as a decimal",1,1,1,0,0,0,0,"EDI",1,1,1,1
"day of year",1,1,1,0,0,0,0,"EDI",1,1,1,1
"dayof month",1,1,1,0,0,0,0,"EDI",1,1,1,1
"dayofmonth",1,1,1,0,0,0,0,"EDI",1,1,1,1
"dayofweek",1,1,1,0,0,0,0,"EDI",1,1,1,1
"dayofyear",1,1,1,0,0,0,0,"EDI",1,1,1,1
"dd-mm-yyyy",1,1,1,0,0,0,0,"EDI",1,1,1,1
"dd-mm-yyyy",1,1,1,0,0,0,0,"EDI",1,1,1,1
"dd-mmm-yyyy",1,1,1,0,0,0,0,"EDI",1,1,1,1
"decayperminuteperliter",1,1,1,0,0,0,0,"EDI",1,1,1,1
"decimal years",1,1,1,0,0,0,0,"EDI",1,1,1,1
"decimals",1,1,1,0,0,0,0,"EDI",1,1,1,1
"decimaltime",1,1,1,0,0,0,0,"EDI",1,1,1,1
"degreecelsiuspermeter",1,1,1,0,0,0,0,"EDI",1,1,1,1
"degreecweeks",1,1,1,0,0,0,0,"EDI",1,1,1,1
"degreefahrenheit",1,1,1,0,0,0,0,"EDI",1,1,1,1
"degrees celsius * 10",1,1,1,0,0,0,0,"EDI",1,1,1,1
"degreesfahrenheit",1,1,1,0,0,0,0,"EDI",1,1,1,1
"deployment year",1,1,1,0,0,0,0,"EDI",1,1,1,1
"deviation from the standard vienna peedee belemnite",1,1,1,0,0,0,0,"EDI",1,1,1,1
"difference in evenness between control plots",1,1,1,0,0,0,0,"EDI",1,1,1,1
"difference in evenness between plots",1,1,1,0,0,0,0,"EDI",1,1,1,1
"difference in probability",1,1,1,0,0,0,0,"EDI",1,1,1,1
"dimensionsless",1,1,1,0,0,0,0,"EDI",1,1,1,1
"dollars",1,1,1,0,0,0,0,"EDI",1,1,1,1
"drygpermsquared",1,1,1,0,0,0,0,"EDI",1,1,1,1
"equivalentperliter",1,1,1,0,0,0,0,"EDI",1,1,1,1
"equivalentsperliter",1,1,1,0,0,0,0,"EDI",1,1,1,1
"euclidean distance bewteen centroids in pcoa space",1,1,1,0,0,0,0,"EDI",1,1,1,1
"experimental id",1,1,1,0,0,0,0,"EDI",1,1,1,1
"fishperschool",1,1,1,0,0,0,0,"EDI",1,1,1,1
"footcubedperacre",1,1,1,0,0,0,0,"EDI",1,1,1,1
"footpersecond",1,1,1,0,0,0,0,"EDI",1,1,1,1
"footsquared",1,1,1,0,0,0,0,"EDI",1,1,1,1
"formazin turbidity unit",1,1,1,0,0,0,0,"EDI",1,1,1,1
"fruitsperindividualperyear",1,1,1,0,0,0,0,"EDI",1,1,1,1
"frustules",1,1,1,0,0,0,0,"EDI",1,1,1,1
"g / cm^3",1,1,1,0,0,0,0,"EDI",1,1,1,1
"g m^-2",1,1,1,0,0,0,0,"EDI",1,1,1,1
"g water / cm^2",1,1,1,0,0,0,0,"EDI",1,1,1,1
"g wosc / square m",1,1,1,0,0,0,0,"EDI",1,1,1,1
"g/0.09m2",1,1,1,0,0,0,0,"EDI",1,1,1,1
"gallonperhour",1,1,1,0,0,0,0,"EDI",1,1,1,1
"gallonperweek",1,1,1,0,0,0,0,"EDI",1,1,1,1
"gco2-c/m^2",1,1,1,0,0,0,0,"EDI",1,1,1,1
"gn/m2",1,1,1,0,0,0,0,"EDI",1,1,1,1
"gnm-2",1,1,1,0,0,0,0,"EDI",1,1,1,1
"gp/m2",1,1,1,0,0,0,0,"EDI",1,1,1,1
"gpercubedcm",1,1,1,0,0,0,0,"EDI",1,1,1,1
"gpi/m2",1,1,1,0,0,0,0,"EDI",1,1,1,1
"gram-carbon per square meter per day",1,1,1,0,0,0,0,"EDI",1,1,1,1
"gram leaf per gram sample",1,1,1,0,0,0,0,"EDI",1,1,1,1
"gram of carbon per kilogram of soil",1,1,1,0,0,0,0,"EDI",1,1,1,1
"gram of nitrogen per kilogram of soil",1,1,1,0,0,0,0,"EDI",1,1,1,1
"gramcarbonperkilogramdrysoil",1,1,1,0,0,0,0,"EDI",1,1,1,1
"gramdryplantbiomassperyear",1,1,1,0,0,0,0,"EDI",1,1,1,1
"gramper1750centimeterqubed",1,1,1,0,0,0,0,"EDI",1,1,1,1
"grampercentimeter",1,1,1,0,0,0,0,"EDI",1,1,1,1
"grampercubicmeter",1,1,1,0,0,0,0,"EDI",1,1,1,1
"grampergram *100",1,1,1,0,0,0,0,"EDI",1,1,1,1
"grampermetercubedperday",1,1,1,0,0,0,0,"EDI",1,1,1,1
"grampermeterpersecond",1,1,1,0,0,0,0,"EDI",1,1,1,1
"grampermetersquare",1,1,1,0,0,0,0,"EDI",1,1,1,1
"grampersquaremeterperday",1,1,1,0,0,0,0,"EDI",1,1,1,1
"grams/square foot",1,1,1,0,0,0,0,"EDI",1,1,1,1
"gramscellulosepergramlitter",1,1,1,0,0,0,0,"EDI",1,1,1,1
"gramsdrymasspersquaremeterper15cmdepthinterval",1,1,1,0,0,0,0,"EDI",1,1,1,1
"gramsdrymasspersquaremeterperyearper15cmdepthinterval",1,1,1,0,0,0,0,"EDI",1,1,1,1
"gramsligninpergramscelluloseandlignin",1,1,1,0,0,0,0,"EDI",1,1,1,1
"gramsligninpergramslitter",1,1,1,0,0,0,0,"EDI",1,1,1,1
"gramspercentimeter",1,1,1,0,0,0,0,"EDI",1,1,1,1
"gramspercentimetercubed",1,1,1,0,0,0,0,"EDI",1,1,1,1
"gramspercentimetersquaredperhour",1,1,1,0,0,0,0,"EDI",1,1,1,1
"gramspercubicmeter(g/m3)",1,1,1,0,0,0,0,"EDI",1,1,1,1
"gramspercubicmeterperyear",1,1,1,0,0,0,0,"EDI",1,1,1,1
"gramsperday",1,1,1,0,0,0,0,"EDI",1,1,1,1
"gramsperhectareperyear",1,1,1,0,0,0,0,"EDI",1,1,1,1
"gramspermonth",1,1,1,0,0,0,0,"EDI",1,1,1,1
"gramspersquaredmeterpercentimeter",1,1,1,0,0,0,0,"EDI",1,1,1,1
"gramspersquaremeter",1,1,1,0,0,0,0,"EDI",1,1,1,1
"gramssquaremeterperday",1,1,1,0,0,0,0,"EDI",1,1,1,1
"hms.s",1,1,1,0,0,0,0,"EDI",1,1,1,1
"individuals/km2",1,1,1,0,0,0,0,"EDI",1,1,1,1
"individualspercubicmeter",1,1,1,0,0,0,0,"EDI",1,1,1,1
"individualspermilliliter",1,1,1,0,0,0,0,"EDI",1,1,1,1
"individualspersquaremeter",1,1,1,0,0,0,0,"EDI",1,1,1,1
"jackson turbidity unit",1,1,1,0,0,0,0,"EDI",1,1,1,1
"joule/gram",1,1,1,0,0,0,0,"EDI",1,1,1,1
"jouleperkelvinperkilogram",1,1,1,0,0,0,0,"EDI",1,1,1,1
"joulepermetersquared",1,1,1,0,0,0,0,"EDI",1,1,1,1
"joulepermole",1,1,1,0,0,0,0,"EDI",1,1,1,1
"joulepersquarecentimetre[j/cm²]",1,1,1,0,0,0,0,"EDI",1,1,1,1
"joulespermetersquare",1,1,1,0,0,0,0,"EDI",1,1,1,1
"joulespersquarecentimeter",1,1,1,0,0,0,0,"EDI",1,1,1,1
"killogramperhectare",1,1,1,0,0,0,0,"EDI",1,1,1,1
"killogramperhectareperday",1,1,1,0,0,0,0,"EDI",1,1,1,1
"kilogram per unit effort",1,1,1,0,0,0,0,"EDI",1,1,1,1
"kilogramperkilogram",1,1,1,0,0,0,0,"EDI",1,1,1,1
"kilogrampermetersquaredperyear",1,1,1,0,0,0,0,"EDI",1,1,1,1
"kilogramspercubicmeters",1,1,1,0,0,0,0,"EDI",1,1,1,1
"kilogramsperhectare",1,1,1,0,0,0,0,"EDI",1,1,1,1
"kilogramsperliter",1,1,1,0,0,0,0,"EDI",1,1,1,1
"kilojoulepersquaremeterperday",1,1,1,0,0,0,0,"EDI",1,1,1,1
"kilometerperhour",1,1,1,0,0,0,0,"EDI",1,1,1,1
"kilometerperkilometersquared",1,1,1,0,0,0,0,"EDI",1,1,1,1
"kilometersperday",1,1,1,0,0,0,0,"EDI",1,1,1,1
"kilowattpersquaremeter",1,1,1,0,0,0,0,"EDI",1,1,1,1
"kilowattspersquaremeter",1,1,1,0,0,0,0,"EDI",1,1,1,1
"l/s",1,1,1,0,0,0,0,"EDI",1,1,1,1
"langleys",1,1,1,0,0,0,0,"EDI",1,1,1,1
"large fish/metercubed/30 minute",1,1,1,0,0,0,0,"EDI",1,1,1,1
"literperday",1,1,1,0,0,0,0,"EDI",1,1,1,1
"literpermeterpermilligram",1,1,1,0,0,0,0,"EDI",1,1,1,1
"literpermetersquaredperday",1,1,1,0,0,0,0,"EDI",1,1,1,1
"litersperhour",1,1,1,0,0,0,0,"EDI",1,1,1,1
"literspermilligram-carbonpermeter.",1,1,1,0,0,0,0,"EDI",1,1,1,1
"literspermilligrams",1,1,1,0,0,0,0,"EDI",1,1,1,1
"log response ratio as a magnitude with sign added (for ease of interpretation)",1,1,1,0,0,0,0,"EDI",1,1,1,1
"log10cellspermililiter",1,1,1,0,0,0,0,"EDI",1,1,1,1
"log10cellspermilliliter",1,1,1,0,0,0,0,"EDI",1,1,1,1
"log10relativefluorescenceunits",1,1,1,0,0,0,0,"EDI",1,1,1,1
"longitude",1,1,1,0,0,0,0,"EDI",1,1,1,1
"lumenspersquarefoot",1,1,1,0,0,0,0,"EDI",1,1,1,1
"luminositypersquarefoot",1,1,1,0,0,0,0,"EDI",1,1,1,1
"luminpermetersquared",1,1,1,0,0,0,0,"EDI",1,1,1,1
"m/d/yyyy",1,1,1,0,0,0,0,"EDI",1,1,1,1
"m^2/ha",1,1,1,0,0,0,0,"EDI",1,1,1,1
"m2pergram",1,1,1,0,0,0,0,"EDI",1,1,1,1
"m3/ha",1,1,1,0,0,0,0,"EDI",1,1,1,1
"m6/hr2",1,1,1,0,0,0,0,"EDI",1,1,1,1
"megagramperhectare",1,1,1,0,0,0,0,"EDI",1,1,1,1
"megajoule per cm2 per year",1,1,1,0,0,0,0,"EDI",1,1,1,1
"megajoulepersquaremeter",1,1,1,0,0,0,0,"EDI",1,1,1,1
"megajoulespermetersquared",1,1,1,0,0,0,0,"EDI",1,1,1,1
"megaliterperkilometersquared",1,1,1,0,0,0,0,"EDI",1,1,1,1
"meq/100 g",1,1,1,0,0,0,0,"EDI",1,1,1,1
"metercubedperhour",1,1,1,0,0,0,0,"EDI",1,1,1,1
"metercubedpermeter",1,1,1,0,0,0,0,"EDI",1,1,1,1
"metercubedpermole",1,1,1,0,0,0,0,"EDI",1,1,1,1
"metercubedwaterpermetercubedsoil",1,1,1,0,0,0,0,"EDI",1,1,1,1
"meterperhour",1,1,1,0,0,0,0,"EDI",1,1,1,1
"meterscubedpersecond",1,1,1,0,0,0,0,"EDI",1,1,1,1
"metersquare",1,1,1,0,0,0,0,"EDI",1,1,1,1
"metersquaredperday",1,1,1,0,0,0,0,"EDI",1,1,1,1
"metersquaredpermetercubed",1,1,1,0,0,0,0,"EDI",1,1,1,1
"metricton",1,1,1,0,0,0,0,"EDI",1,1,1,1
"metrictonperhectare",1,1,1,0,0,0,0,"EDI",1,1,1,1
"mg active c / cm^2",1,1,1,0,0,0,0,"EDI",1,1,1,1
"mg active c / g dry soil",1,1,1,0,0,0,0,"EDI",1,1,1,1
"mg active n / cm^2",1,1,1,0,0,0,0,"EDI",1,1,1,1
"mg active n / kg dry soil",1,1,1,0,0,0,0,"EDI",1,1,1,1
"mg c / cm^2",1,1,1,0,0,0,0,"EDI",1,1,1,1
"mg c / g soil",1,1,1,0,0,0,0,"EDI",1,1,1,1
"mg c per mg sample",1,1,1,0,0,0,0,"EDI",1,1,1,1
"mg cl / l",1,1,1,0,0,0,0,"EDI",1,1,1,1
"mg fine particles / cm^2",1,1,1,0,0,0,0,"EDI",1,1,1,1
"mg mineral n / cm^2",1,1,1,0,0,0,0,"EDI",1,1,1,1
"mg mineral n / kg dry soil",1,1,1,0,0,0,0,"EDI",1,1,1,1
"mg n / cm^2",1,1,1,0,0,0,0,"EDI",1,1,1,1
"mg n / g soil",1,1,1,0,0,0,0,"EDI",1,1,1,1
"mg n per mg sample",1,1,1,0,0,0,0,"EDI",1,1,1,1
"mg n/g soil",1,1,1,0,0,0,0,"EDI",1,1,1,1
"mg no3-n / g soil",1,1,1,0,0,0,0,"EDI",1,1,1,1
"mg non-mobile c / cm^2",1,1,1,0,0,0,0,"EDI",1,1,1,1
"mg non-mobile c / g dry soil",1,1,1,0,0,0,0,"EDI",1,1,1,1
"mg non-mobile n / cm^2",1,1,1,0,0,0,0,"EDI",1,1,1,1
"mg non-mobile n / kg dry soil",1,1,1,0,0,0,0,"EDI",1,1,1,1
"mg opo4-p / l",1,1,1,0,0,0,0,"EDI",1,1,1,1
"mg org c / cm^2",1,1,1,0,0,0,0,"EDI",1,1,1,1
"mg org c / g dry soil",1,1,1,0,0,0,0,"EDI",1,1,1,1
"mg org n / cm^2",1,1,1,0,0,0,0,"EDI",1,1,1,1
"mg org n / kg dry soil",1,1,1,0,0,0,0,"EDI",1,1,1,1
"mg organic matter / cm^2",1,1,1,0,0,0,0,"EDI",1,1,1,1
"mg p / l",1,1,1,0,0,0,0,"EDI",1,1,1,1
"mg s/l",1,1,1,0,0,0,0,"EDI",1,1,1,1
"mg so4 / l",1,1,1,0,0,0,0,"EDI",1,1,1,1
"mg wsoc / g soil",1,1,1,0,0,0,0,"EDI",1,1,1,1
"mg/gdw",1,1,1,0,0,0,0,"EDI",1,1,1,1
"mg/l/g/hr",1,1,1,0,0,0,0,"EDI",1,1,1,1
"mg/lofnh4+/gofrootbiomass",1,1,1,0,0,0,0,"EDI",1,1,1,1
"mg/shoot",1,1,1,0,0,0,0,"EDI",1,1,1,1
"mgn/gdrysoil",1,1,1,0,0,0,0,"EDI",1,1,1,1
"mgn/gsoiln",1,1,1,0,0,0,0,"EDI",1,1,1,1
"micro-atmosphere ",1,1,1,0,0,0,0,"EDI",1,1,1,1
"microeinsteinpermetersquared",1,1,1,0,0,0,0,"EDI",1,1,1,1
"microgram",1,1,1,0,0,0,0,"EDI",1,1,1,1
"microgramc-co2pergramdrysoilperday",1,1,1,0,0,0,0,"EDI",1,1,1,1
"microgramnpergramdrysoil",1,1,1,0,0,0,0,"EDI",1,1,1,1
"microgramp/gsoil",1,1,1,0,0,0,0,"EDI",1,1,1,1
"microgrampercountperminute",1,1,1,0,0,0,0,"EDI",1,1,1,1
"microgrampergram",1,1,1,0,0,0,0,"EDI",1,1,1,1
"microgrampergrampercountperminute",1,1,1,0,0,0,0,"EDI",1,1,1,1
"micrograms per squared centimeter",1,1,1,0,0,0,0,"EDI",1,1,1,1
"microgramsammoniumpertencentimetersquareexchangeresinpertenweeks",1,1,1,0,0,0,0,"EDI",1,1,1,1
"microgramsnitratepertencentimetersquareexchangeresinpertenweeks",1,1,1,0,0,0,0,"EDI",1,1,1,1
"microgramsnitrogenpertencentimetersquareexchangeresinpertenweeks",1,1,1,0,0,0,0,"EDI",1,1,1,1
"microgramsperbag",1,1,1,0,0,0,0,"EDI",1,1,1,1
"microgramspergram",1,1,1,0,0,0,0,"EDI",1,1,1,1
"microgramsperliterperminute",1,1,1,0,0,0,0,"EDI",1,1,1,1
"microgramspermetercubed",1,1,1,0,0,0,0,"EDI",1,1,1,1
"microgramspersquaremeterperhour",1,1,1,0,0,0,0,"EDI",1,1,1,1
"microgramsphosphoruspertencentimetersquareexchangeresinpertenweeks",1,1,1,0,0,0,0,"EDI",1,1,1,1
"microliterperliter",1,1,1,0,0,0,0,"EDI",1,1,1,1
"micrometercubedpermillimetersquared",1,1,1,0,0,0,0,"EDI",1,1,1,1
"micromohspercentimeter",1,1,1,0,0,0,0,"EDI",1,1,1,1
"micromol co2 per mol water (umol/mol)",1,1,1,0,0,0,0,"EDI",1,1,1,1
"micromole",1,1,1,0,0,0,0,"EDI",1,1,1,1
"micromolepercentimetersquaredperhour",1,1,1,0,0,0,0,"EDI",1,1,1,1
"micromolepercentimetersquaredperhourperphotonflux",1,1,1,0,0,0,0,"EDI",1,1,1,1
"micromolepergramperday",1,1,1,0,0,0,0,"EDI",1,1,1,1
"micromolepermetercubed",1,1,1,0,0,0,0,"EDI",1,1,1,1
"micromolepermetersqauredpersecond",1,1,1,0,0,0,0,"EDI",1,1,1,1
"micromolepermilligramperhour",1,1,1,0,0,0,0,"EDI",1,1,1,1
"micromolepersecondpersquaremeter",1,1,1,0,0,0,0,"EDI",1,1,1,1
"micromolepersquarecentimeterperhour",1,1,1,0,0,0,0,"EDI",1,1,1,1
"micromolepersquaremeter",1,1,1,0,0,0,0,"EDI",1,1,1,1
"micromoles",1,1,1,0,0,0,0,"EDI",1,1,1,1
"micromoles",1,1,1,0,0,0,0,"EDI",1,1,1,1
"micromolesm-2s-1",1,1,1,0,0,0,0,"EDI",1,1,1,1
"micromolesnassimilated/gnodule(dwt)/hr",1,1,1,0,0,0,0,"EDI",1,1,1,1
"micromolespermetersquaredpersec",1,1,1,0,0,0,0,"EDI",1,1,1,1
"micromolespermetersquarepersecond",1,1,1,0,0,0,0,"EDI",1,1,1,1
"micromolespermol",1,1,1,0,0,0,0,"EDI",1,1,1,1
"micromolespermolesquaredpersecond ",1,1,1,0,0,0,0,"EDI",1,1,1,1
"micromolespersecondpermetersquared",1,1,1,0,0,0,0,"EDI",1,1,1,1
"micromolespersecondpersquaremeter",1,1,1,0,0,0,0,"EDI",1,1,1,1
"micromolperliterperhour",1,1,1,0,0,0,0,"EDI",1,1,1,1
"micromolpermetersquaredpersecond",1,1,1,0,0,0,0,"EDI",1,1,1,1
"micromolphotonspermetersquaredpersecond",1,1,1,0,0,0,0,"EDI",1,1,1,1
"micromolphotonspersquaremeterpersecond",1,1,1,0,0,0,0,"EDI",1,1,1,1
"micromols per meter square per second",1,1,1,0,0,0,0,"EDI",1,1,1,1
"micromolsperliter",1,1,1,0,0,0,0,"EDI",1,1,1,1
"micromolspermetersquaredpersecond",1,1,1,0,0,0,0,"EDI",1,1,1,1
"microohm",1,1,1,0,0,0,0,"EDI",1,1,1,1
"micros/cm",1,1,1,0,0,0,0,"EDI",1,1,1,1
"microseimenspersquarecentimeter",1,1,1,0,0,0,0,"EDI",1,1,1,1
"microsiemenpercentimeter",1,1,1,0,0,0,0,"EDI",1,1,1,1
"microsiemens per centimeter",1,1,1,0,0,0,0,"EDI",1,1,1,1
"microsiemens per centimeter; μs/cm",1,1,1,0,0,0,0,"EDI",1,1,1,1
"milesperhour",1,1,1,0,0,0,0,"EDI",1,1,1,1
"mili bar",1,1,1,0,0,0,0,"EDI",1,1,1,1
"miligram-carbon per square meter per day",1,1,1,0,0,0,0,"EDI",1,1,1,1
"miligramsperliterperday",1,1,1,0,0,0,0,"EDI",1,1,1,1
"milimeterperday",1,1,1,0,0,0,0,"EDI",1,1,1,1
"milimeterperyear",1,1,1,0,0,0,0,"EDI",1,1,1,1
"millgramspergram	",1,1,1,0,0,0,0,"EDI",1,1,1,1
"milliequiv/l",1,1,1,0,0,0,0,"EDI",1,1,1,1
"milliequivalent",1,1,1,0,0,0,0,"EDI",1,1,1,1
"milliequivalentsofchargeper100gram",1,1,1,0,0,0,0,"EDI",1,1,1,1
"milliequivalentsper100grams",1,1,1,0,0,0,0,"EDI",1,1,1,1
"milliequivalentsperliter",1,1,1,0,0,0,0,"EDI",1,1,1,1
"milligramcarbonpergenecopyperhour",1,1,1,0,0,0,0,"EDI",1,1,1,1
"milligramcarbonpergramdrysoilperhour",1,1,1,0,0,0,0,"EDI",1,1,1,1
"milligramnitrogenperkilogramdrysoilperday",1,1,1,0,0,0,0,"EDI",1,1,1,1
"milligrampergramdryweight",1,1,1,0,0,0,0,"EDI",1,1,1,1
"milligramperkilogramperhour",1,1,1,0,0,0,0,"EDI",1,1,1,1
"milligramperliterascalciumcarbonate",1,1,1,0,0,0,0,"EDI",1,1,1,1
"milligrampermilligram",1,1,1,0,0,0,0,"EDI",1,1,1,1
"milligrams of nitrate per kilogram dry soil per day",1,1,1,0,0,0,0,"EDI",1,1,1,1
"milligrams of nitrogen (ammonium & nitrate) per kilogram dry soil per day",1,1,1,0,0,0,0,"EDI",1,1,1,1
"milligrams oxygen per gram dry mass of litter per hour",1,1,1,0,0,0,0,"EDI",1,1,1,1
"milligrams per day",1,1,1,0,0,0,0,"EDI",1,1,1,1
"milligrams per square meter",1,1,1,0,0,0,0,"EDI",1,1,1,1
"milligramsdonpermeter",1,1,1,0,0,0,0,"EDI",1,1,1,1
"milligramsdonpermilligramsdoc",1,1,1,0,0,0,0,"EDI",1,1,1,1
"milligramsperliter (mg/l)",1,1,1,0,0,0,0,"EDI",1,1,1,1
"milligramsperliter (mg/l)",1,1,1,0,0,0,0,"EDI",1,1,1,1
"milligramspersquaremeterperday",1,1,1,0,0,0,0,"EDI",1,1,1,1
"milligranpermetersquaredpersecond",1,1,1,0,0,0,0,"EDI",1,1,1,1
"milliliterperhour",1,1,1,0,0,0,0,"EDI",1,1,1,1
"milliliterperliter_keep",1,1,1,0,0,0,0,"EDI",1,1,1,1
"milliliterperminute",1,1,1,0,0,0,0,"EDI",1,1,1,1
"millilitersperhour",1,1,1,0,0,0,0,"EDI",1,1,1,1
"milliliterspermilliliter",1,1,1,0,0,0,0,"EDI",1,1,1,1
"millimetecubedrperliter",1,1,1,0,0,0,0,"EDI",1,1,1,1
"millimetersmercury",1,1,1,0,0,0,0,"EDI",1,1,1,1
"millimetersper year",1,1,1,0,0,0,0,"EDI",1,1,1,1
"millimeterspergram",1,1,1,0,0,0,0,"EDI",1,1,1,1
"millimetersperleafperday",1,1,1,0,0,0,0,"EDI",1,1,1,1
"millimeterspersecondperday",1,1,1,0,0,0,0,"EDI",1,1,1,1
"millimhopercentimeter",1,1,1,0,0,0,0,"EDI",1,1,1,1
"millimolar",1,1,1,0,0,0,0,"EDI",1,1,1,1
"millimolepermetercubedperminute",1,1,1,0,0,0,0,"EDI",1,1,1,1
"millimolepermeterperminute",1,1,1,0,0,0,0,"EDI",1,1,1,1
"millimolepermetersquared",1,1,1,0,0,0,0,"EDI",1,1,1,1
"millimolepermetersquaredperminute",1,1,1,0,0,0,0,"EDI",1,1,1,1
"millimolepermetersquaredpersecond",1,1,1,0,0,0,0,"EDI",1,1,1,1
"millimolesperkilogram",1,1,1,0,0,0,0,"EDI",1,1,1,1
"millimolespersecond",1,1,1,0,0,0,0,"EDI",1,1,1,1
"milliseimenpercentimeter",1,1,1,0,0,0,0,"EDI",1,1,1,1
"millisiemen",1,1,1,0,0,0,0,"EDI",1,1,1,1
"millisiemen",1,1,1,0,0,0,0,"EDI",1,1,1,1
"millisiemens",1,1,1,0,0,0,0,"EDI",1,1,1,1
"millisiemens per centimeter",1,1,1,0,0,0,0,"EDI",1,1,1,1
"millisiemenspercentimeter (ms/cm)",1,1,1,0,0,0,0,"EDI",1,1,1,1
"millisiemenspermeter",1,1,1,0,0,0,0,"EDI",1,1,1,1
"millivots",1,1,1,0,0,0,0,"EDI",1,1,1,1
"ml02/hr",1,1,1,0,0,0,0,"EDI",1,1,1,1
"mlo2hr",1,1,1,0,0,0,0,"EDI",1,1,1,1
"mm/dd/yyhh:mm",1,1,1,0,0,0,0,"EDI",1,1,1,1
"mmol co2/m2/s",1,1,1,0,0,0,0,"EDI",1,1,1,1
"mmol h2o/m2/s",1,1,1,0,0,0,0,"EDI",1,1,1,1
"mmolm-2s-1",1,1,1,0,0,0,0,"EDI",1,1,1,1
"mol co2 m-2 s-1",1,1,1,0,0,0,0,"EDI",1,1,1,1
"mol h20/m2sec",1,1,1,0,0,0,0,"EDI",1,1,1,1
"molesperday",1,1,1,0,0,0,0,"EDI",1,1,1,1
"molm-2s-1",1,1,1,0,0,0,0,"EDI",1,1,1,1
"molperatmosphere",1,1,1,0,0,0,0,"EDI",1,1,1,1
"monthlydmaridityindex",1,1,1,0,0,0,0,"EDI",1,1,1,1
"nanamolepergramperhour",1,1,1,0,0,0,0,"EDI",1,1,1,1
"nanogramspersquarecentimeterperminute",1,1,1,0,0,0,0,"EDI",1,1,1,1
"nanomolepermetersquaredperday",1,1,1,0,0,0,0,"EDI",1,1,1,1
"nanomolepermilligramperhour ",1,1,1,0,0,0,0,"EDI",1,1,1,1
"nanomoleperminute",1,1,1,0,0,0,0,"EDI",1,1,1,1
"nanomolespercentimetersquaredperminute",1,1,1,0,0,0,0,"EDI",1,1,1,1
"nanomolesperliterperday",1,1,1,0,0,0,0,"EDI",1,1,1,1
"nanomolespermetersquaredpersecond",1,1,1,0,0,0,0,"EDI",1,1,1,1
"nanomolperliterperday",1,1,1,0,0,0,0,"EDI",1,1,1,1
"natural units per milliliter",1,1,1,0,0,0,0,"EDI",1,1,1,1
"negative log h+",1,1,1,0,0,0,0,"EDI",1,1,1,1
"nephelometric turbidity unit",1,1,1,0,0,0,0,"EDI",1,1,1,1
"nephelometricturbidityunits",1,1,1,0,0,0,0,"EDI",1,1,1,1
"nephelometricturbidityunits ",1,1,1,0,0,0,0,"EDI",1,1,1,1
"nephlometricturbidityunits",1,1,1,0,0,0,0,"EDI",1,1,1,1
"nesslerturbidityunit",1,1,1,0,0,0,0,"EDI",1,1,1,1
"net night or hr",1,1,1,0,0,0,0,"EDI",1,1,1,1
"newtons/dy",1,1,1,0,0,0,0,"EDI",1,1,1,1
"ng/m^2",1,1,1,0,0,0,0,"EDI",1,1,1,1
"ng/m^3",1,1,1,0,0,0,0,"EDI",1,1,1,1
"ng/m^4",1,1,1,0,0,0,0,"EDI",1,1,1,1
"ngn20gsoil-1h-1",1,1,1,0,0,0,0,"EDI",1,1,1,1
"ngn20m-2h-1",1,1,1,0,0,0,0,"EDI",1,1,1,1
"nm d-1",1,1,1,0,0,0,0,"EDI",1,1,1,1
"nm d-1 x 10-3",1,1,1,0,0,0,0,"EDI",1,1,1,1
"nmolperhourpergram",1,1,1,0,0,0,0,"EDI",1,1,1,1
"no unit",1,1,1,0,0,0,0,"EDI",1,1,1,1
"no units",1,1,1,0,0,0,0,"EDI",1,1,1,1
"nominal month",1,1,1,0,0,0,0,"EDI",1,1,1,1
"nominalmonthsperyear",1,1,1,0,0,0,0,"EDI",1,1,1,1
"number of households",1,1,1,0,0,0,0,"EDI",1,1,1,1
"number of seconds of time",1,1,1,0,0,0,0,"EDI",1,1,1,1
"number of taxon",1,1,1,0,0,0,0,"EDI",1,1,1,1
"number per m2",1,1,1,0,0,0,0,"EDI",1,1,1,1
"number per m2 per day",1,1,1,0,0,0,0,"EDI",1,1,1,1
"number per unit effort",1,1,1,0,0,0,0,"EDI",1,1,1,1
"numbercells/milliliter",1,1,1,0,0,0,0,"EDI",1,1,1,1
"numberper100centimetersquare",1,1,1,0,0,0,0,"EDI",1,1,1,1
"numberpergramperminute",1,1,1,0,0,0,0,"EDI",1,1,1,1
"numberperhour",1,1,1,0,0,0,0,"EDI",1,1,1,1
"numberperkilometershoreline",1,1,1,0,0,0,0,"EDI",1,1,1,1
"numberpermeterquartered",1,1,1,0,0,0,0,"EDI",1,1,1,1
"numberpermetersquare",1,1,1,0,0,0,0,"EDI",1,1,1,1
"numberpermillimetersquared",1,1,1,0,0,0,0,"EDI",1,1,1,1
"numberperplot",1,1,1,0,0,0,0,"EDI",1,1,1,1
"numberpersquaremile",1,1,1,0,0,0,0,"EDI",1,1,1,1
"numberperthreetenthsmetersquared",1,1,1,0,0,0,0,"EDI",1,1,1,1
"numberpertrapperhour",1,1,1,0,0,0,0,"EDI",1,1,1,1
"numberpertree",1,1,1,0,0,0,0,"EDI",1,1,1,1
"omega",1,1,1,0,0,0,0,"EDI",1,1,1,1
"ounce (oz)",1,1,1,0,0,0,0,"EDI",1,1,1,1
"ounces",1,1,1,0,0,0,0,"EDI",1,1,1,1
"panels",1,1,1,0,0,0,0,"EDI",1,1,1,1
"part per trillion",1,1,1,0,0,0,0,"EDI",1,1,1,1
"partpertthousand",1,1,1,0,0,0,0,"EDI",1,1,1,1
"partspermillion",1,1,1,0,0,0,0,"EDI",1,1,1,1
"partspermillionbyvolume",1,1,1,0,0,0,0,"EDI",1,1,1,1
"pascalperhectopascal",1,1,1,0,0,0,0,"EDI",1,1,1,1
"pendent id",1,1,1,0,0,0,0,"EDI",1,1,1,1
"percent nitrogen not measured on this sample, or sample was lost",1,1,1,0,0,0,0,"EDI",1,1,1,1
"percent per thousand",1,1,1,0,0,0,0,"EDI",1,1,1,1
"percentna",1,1,1,0,0,0,0,"EDI",1,1,1,1
"percentofdrymass",1,1,1,0,0,0,0,"EDI",1,1,1,1
"percentofwetweight",1,1,1,0,0,0,0,"EDI",1,1,1,1
"permeg",1,1,1,0,0,0,0,"EDI",1,1,1,1
"permeter",1,1,1,0,0,0,0,"EDI",1,1,1,1
"permeterpermilligramsdoc",1,1,1,0,0,0,0,"EDI",1,1,1,1
"permillevsvpdb",1,1,1,0,0,0,0,"EDI",1,1,1,1
"ph ",1,1,1,0,0,0,0,"EDI",1,1,1,1
"photosyntheticphotonfluxdensity",1,1,1,0,0,0,0,"EDI",1,1,1,1
"phunits",1,1,1,0,0,0,0,"EDI",1,1,1,1
"picogramspermilliliter",1,1,1,0,0,0,0,"EDI",1,1,1,1
"picomolesco2persecond",1,1,1,0,0,0,0,"EDI",1,1,1,1
"picomoleso2persecond",1,1,1,0,0,0,0,"EDI",1,1,1,1
"platinum cobalt units",1,1,1,0,0,0,0,"EDI",1,1,1,1
"plot",1,1,1,0,0,0,0,"EDI",1,1,1,1
"pointpersquaremeter",1,1,1,0,0,0,0,"EDI",1,1,1,1
"points",1,1,1,0,0,0,0,"EDI",1,1,1,1
"populationdensitypermilesquared",1,1,1,0,0,0,0,"EDI",1,1,1,1
"poundperpersonperday",1,1,1,0,0,0,0,"EDI",1,1,1,1
"poundpersquareinch",1,1,1,0,0,0,0,"EDI",1,1,1,1
"poundspersecond",1,1,1,0,0,0,0,"EDI",1,1,1,1
"ppmpersecond",1,1,1,0,0,0,0,"EDI",1,1,1,1
"practicalsalinityscale",1,1,1,0,0,0,0,"EDI",1,1,1,1
"practicalsalinityunity",1,1,1,0,0,0,0,"EDI",1,1,1,1
"primary key",1,1,1,0,0,0,0,"EDI",1,1,1,1
"proportion ",1,1,1,0,0,0,0,"EDI",1,1,1,1
"proportion of initial dry mass lost per day based on the asymptotic model of decay (howard and howard 1974)",1,1,1,0,0,0,0,"EDI",1,1,1,1
"quininesulfateequivalents",1,1,1,0,0,0,0,"EDI",1,1,1,1
"quininesulfatesunit",1,1,1,0,0,0,0,"EDI",1,1,1,1
"r^2",1,1,1,0,0,0,0,"EDI",1,1,1,1
"rank score",1,1,1,0,0,0,0,"EDI",1,1,1,1
"rat per trap",1,1,1,0,0,0,0,"EDI",1,1,1,1
"rat per trap per date",1,1,1,0,0,0,0,"EDI",1,1,1,1
"ratio",1,1,1,0,0,0,0,"EDI",1,1,1,1
"relation",1,1,1,0,0,0,0,"EDI",1,1,1,1
"relative difference in number of species bewteen copmared control plots",1,1,1,0,0,0,0,"EDI",1,1,1,1
"relative difference in number of species bewteen copmared plots",1,1,1,0,0,0,0,"EDI",1,1,1,1
"relativeflorescenceunits",1,1,1,0,0,0,0,"EDI",1,1,1,1
"relativeflourescenceunits",1,1,1,0,0,0,0,"EDI",1,1,1,1
"relativeflourescentunit",1,1,1,0,0,0,0,"EDI",1,1,1,1
"rep",1,1,1,0,0,0,0,"EDI",1,1,1,1
"revolutionperminute",1,1,1,0,0,0,0,"EDI",1,1,1,1
"rotation end",1,1,1,0,0,0,0,"EDI",1,1,1,1
"rotation start",1,1,1,0,0,0,0,"EDI",1,1,1,1
"saffir-simpson category",1,1,1,0,0,0,0,"EDI",1,1,1,1
"seawater clarity",1,1,1,0,0,0,0,"EDI",1,1,1,1
"secondspercentimeter",1,1,1,0,0,0,0,"EDI",1,1,1,1
"see unit_name column",1,1,1,0,0,0,0,"EDI",1,1,1,1
"seed per a",1,1,1,0,0,0,0,"EDI",1,1,1,1
"serialdatenumberyear0000",1,1,1,0,0,0,0,"EDI",1,1,1,1
"shoots per",1,1,1,0,0,0,0,"EDI",1,1,1,1
"short-shootpermetersquared",1,1,1,0,0,0,0,"EDI",1,1,1,1
"sign of % proportional change 1 if positive, -1 if negative",1,1,1,0,0,0,0,"EDI",1,1,1,1
"simulation",1,1,1,0,0,0,0,"EDI",1,1,1,1
"spectral index (band ratio)",1,1,1,0,0,0,0,"EDI",1,1,1,1
"square millimeters",1,1,1,0,0,0,0,"EDI",1,1,1,1
"squarecentimeterspersecondperday",1,1,1,0,0,0,0,"EDI",1,1,1,1
"squaredcentimetersperleafperday",1,1,1,0,0,0,0,"EDI",1,1,1,1
"squaremeterpergram",1,1,1,0,0,0,0,"EDI",1,1,1,1
"squaremeters",1,1,1,0,0,0,0,"EDI",1,1,1,1
"squaremicrometer",1,1,1,0,0,0,0,"EDI",1,1,1,1
"squaremicrometers",1,1,1,0,0,0,0,"EDI",1,1,1,1
"squaremillimeter",0,0,0,1,1,1,0,"NEON",1,1,1,1
"stems per 0.1 ha",1,1,1,0,0,0,0,"EDI",1,1,1,1
"stoat per trap",1,1,1,0,0,0,0,"EDI",1,1,1,1
"stoats per trap per date",1,1,1,0,0,0,0,"EDI",1,1,1,1
"subsample number",1,1,1,0,0,0,0,"EDI",1,1,1,1
"suva[254nm] l/mg*m",1,1,1,0,0,0,0,"EDI",1,1,1,1
"t.u.",1,1,1,0,0,0,0,"EDI",1,1,1,1
"tag number",1,1,1,0,0,0,0,"EDI",1,1,1,1
"taxa identification number",1,1,1,0,0,0,0,"EDI",1,1,1,1
"taxon length",1,1,1,0,0,0,0,"EDI",1,1,1,1
"thermal unit",1,1,1,0,0,0,0,"EDI",1,1,1,1
"thousands of us dollars (1987 value)",1,1,1,0,0,0,0,"EDI",1,1,1,1
"tmi",1,1,1,0,0,0,0,"EDI",1,1,1,1
"total count",1,1,1,0,0,0,0,"EDI",1,1,1,1
"trees/ha",1,1,1,0,0,0,0,"EDI",1,1,1,1
"ug-n/g dry soil/hour",1,1,1,0,0,0,0,"EDI",1,1,1,1
"ug/gdw",1,1,1,0,0,0,0,"EDI",1,1,1,1
"ugc/g soil",1,1,1,0,0,0,0,"EDI",1,1,1,1
"ugc/g soil/day",1,1,1,0,0,0,0,"EDI",1,1,1,1
"ugc/gc/hr",1,1,1,0,0,0,0,"EDI",1,1,1,1
"ugc/gdw/hr",1,1,1,0,0,0,0,"EDI",1,1,1,1
"ugcarbon/liter*day",1,1,1,0,0,0,0,"EDI",1,1,1,1
"ugn2o-n/kgdrysoil*h",1,1,1,0,0,0,0,"EDI",1,1,1,1
"um c",1,1,1,0,0,0,0,"EDI",1,1,1,1
"um p",1,1,1,0,0,0,0,"EDI",1,1,1,1
"umhos/cm",1,1,1,0,0,0,0,"EDI",1,1,1,1
"umol co2 m-2 s-1",1,1,1,0,0,0,0,"EDI",1,1,1,1
"umolphotons/m2/day",1,1,1,0,0,0,0,"EDI",1,1,1,1
"undefined",1,1,1,0,0,0,0,"EDI",1,1,1,1
"unique id",1,1,1,0,0,0,0,"EDI",1,1,1,1
"unique identifier",1,1,1,0,0,0,0,"EDI",1,1,1,1
"unitless- ratio",1,1,1,0,0,0,0,"EDI",1,1,1,1
"unitless ",1,1,1,0,0,0,0,"EDI",1,1,1,1
"unitless -ratio",1,1,1,0,0,0,0,"EDI",1,1,1,1
"unitless id",1,1,1,0,0,0,0,"EDI",1,1,1,1
"usiemes/cm",1,1,1,0,0,0,0,"EDI",1,1,1,1
"uv*min",1,1,1,0,0,0,0,"EDI",1,1,1,1
"value",1,1,1,0,0,0,0,"EDI",1,1,1,1
"variance of center of mass",1,1,1,0,0,0,0,"EDI",1,1,1,1
"variance of center of mass",1,1,1,0,0,0,0,"EDI",1,1,1,1
"varroaperday",1,1,1,0,0,0,0,"EDI",1,1,1,1
"volumetricsoilmoisture",1,1,1,0,0,0,0,"EDI",1,1,1,1
"week",1,1,1,0,0,0,0,"EDI",1,1,1,1
"whole bees",1,1,1,0,0,0,0,"EDI",1,1,1,1
"wood cords",1,1,1,0,0,0,0,"EDI",1,1,1,1
"yeaer (yyyy)",1,1,1,0,0,0,0,"EDI",1,1,1,1
"year (june-may)",1,1,1,0,0,0,0,"EDI",1,1,1,1
"year (yyyy)oter",1,1,1,0,0,0,0,"EDI",1,1,1,1
"yearad",1,1,1,0,0,0,0,"EDI",1,1,1,1
"yy",1,1,1,0,0,0,0,"EDI",1,1,1,1
"yyyy-mm-ddd",1,1,1,0,0,0,0,"EDI",1,1,1,1
"-2",0,0,0,0,0,0,1,"DataOne",1,0,0,1
"-3",0,0,0,0,0,0,1,"DataOne",1,0,0,1
"-3.358",0,0,0,0,0,0,1,"DataOne",1,0,0,1
"-3.46",0,0,0,0,0,0,1,"DataOne",1,0,0,1
"-60",0,0,0,0,0,0,1,"DataOne",1,0,0,1
"-78",0,0,0,0,0,0,1,"DataOne",1,0,0,1
"-999",0,0,0,0,0,0,1,"DataOne",1,0,0,1
"-9999",0,0,0,0,0,0,1,"DataOne",1,0,0,1
"# observed / (# visits * # points)",0,0,0,0,0,0,1,"DataOne",1,0,0,1
"(c) celsius",0,0,0,0,0,0,1,"DataOne",1,0,0,1
"(ma) millions of years ago",0,0,0,0,0,0,1,"DataOne",1,0,0,1
"(mmol/m2/d)",0,0,0,0,0,0,1,"DataOne",1,0,0,1
".01 in/event",0,0,0,0,0,0,1,"DataOne",1,0,0,1
"<< empty cell >>",0,0,0,0,0,0,1,"DataOne",1,0,0,1
"<= 1",0,0,0,0,0,0,1,"DataOne",1,0,0,1
"<175 um",0,0,0,0,0,0,1,"DataOne",1,0,0,1
"<2000 um",0,0,0,0,0,0,1,"DataOne",1,0,0,1
"<500 um",0,0,0,0,0,0,1,"DataOne",1,0,0,1
"<63 um",0,0,0,0,0,0,1,"DataOne",1,0,0,1
">1 to 5",0,0,0,0,0,0,1,"DataOne",1,0,0,1
">10 to 20",0,0,0,0,0,0,1,"DataOne",1,0,0,1
">20 to 50",0,0,0,0,0,0,1,"DataOne",1,0,0,1
">5 to 10",0,0,0,0,0,0,1,"DataOne",1,0,0,1
">90 percent",0,0,0,0,0,0,1,"DataOne",1,0,0,1
">modern",0,0,0,0,0,0,1,"DataOne",1,0,0,1
">modern",0,0,0,0,0,0,1,"DataOne",1,0,0,1
"0",0,0,0,0,0,0,1,"DataOne",1,0,0,1
"0% (quantile)",0,0,0,0,0,0,1,"DataOne",1,0,0,1
"0, 1, 2, 3, 4, 5, na",0,0,0,0,0,0,1,"DataOne",1,0,0,1
"0, 1, 2, 3, na",0,0,0,0,0,0,1,"DataOne",1,0,0,1
"0.01",0,0,0,0,0,0,1,"DataOne",1,0,0,1
"0.5% (quantile)",0,0,0,0,0,0,1,"DataOne",1,0,0,1
"0.711006944444444",0,0,0,0,0,0,1,"DataOne",1,0,0,1
"01001-56045",0,0,0,0,0,0,1,"DataOne",1,0,0,1
"1'",0,0,0,0,0,0,1,"DataOne",1,0,0,1
"1-840",0,0,0,0,0,0,1,"DataOne",1,0,0,1
"1""",0,0,0,0,0,0,1,"DataOne",1,0,0,1
"1, 3",0,0,0,0,0,0,1,"DataOne",1,0,0,1
"1, 5",0,0,0,0,0,0,1,"DataOne",1,0,0,1
"1.1",0,0,0,0,0,0,1,"DataOne",1,0,0,1
"1.2",0,0,0,0,0,0,1,"DataOne",1,0,0,1
"1.2-snapshot",0,0,0,0,0,0,1,"DataOne",1,0,0,1
"1_osage",0,0,0,0,0,0,1,"DataOne",1,0,0,1
"10-33 percent",0,0,0,0,0,0,1,"DataOne",1,0,0,1
"10% (quantile)",0,0,0,0,0,0,1,"DataOne",1,0,0,1
"10_fort_randall",0,0,0,0,0,0,1,"DataOne",1,0,0,1
"100% (maximum)",0,0,0,0,0,0,1,"DataOne",1,0,0,1
"1000*numberperhectare",0,0,0,0,0,0,1,"DataOne",1,0,0,1
"10000",0,0,0,0,0,0,1,"DataOne",1,0,0,1
"101",0,0,0,0,0,0,1,"DataOne",1,0,0,1
"102",0,0,0,0,0,0,1,"DataOne",1,0,0,1
"105.540558877",0,0,0,0,0,0,1,"DataOne",1,0,0,1
"11",0,0,0,0,0,0,1,"DataOne",1,0,0,1
"11.931243",0,0,0,0,0,0,1,"DataOne",1,0,0,1
"111",0,0,0,0,0,0,1,"DataOne",1,0,0,1
"116",0,0,0,0,0,0,1,"DataOne",1,0,0,1
"12.039285",0,0,0,0,0,0,1,"DataOne",1,0,0,1
"120",0,0,0,0,0,0,1,"DataOne",1,0,0,1
"121",0,0,0,0,0,0,1,"DataOne",1,0,0,1
"124",0,0,0,0,0,0,1,"DataOne",1,0,0,1
"125",0,0,0,0,0,0,1,"DataOne",1,0,0,1
"126",0,0,0,0,0,0,1,"DataOne",1,0,0,1
"127",0,0,0,0,0,0,1,"DataOne",1,0,0,1
"128",0,0,0,0,0,0,1,"DataOne",1,0,0,1
"128",0,0,0,0,0,0,1,"DataOne",1,0,0,1
"129",0,0,0,0,0,0,1,"DataOne",1,0,0,1
"130",0,0,0,0,0,0,1,"DataOne",1,0,0,1
"133.757442",0,0,0,0,0,0,1,"DataOne",1,0,0,1
"134",0,0,0,0,0,0,1,"DataOne",1,0,0,1
"135",0,0,0,0,0,0,1,"DataOne",1,0,0,1
"140",0,0,0,0,0,0,1,"DataOne",1,0,0,1
"15'",0,0,0,0,0,0,1,"DataOne",1,0,0,1
"15 min-fixed int",0,0,0,0,0,0,1,"DataOne",1,0,0,1
"150",0,0,0,0,0,0,1,"DataOne",1,0,0,1
"16",0,0,0,0,0,0,1,"DataOne",1,0,0,1
"1603200179",0,0,0,0,0,0,1,"DataOne",1,0,0,1
"160921-075016-jeorse.csv",0,0,0,0,0,0,1,"DataOne",1,0,0,1
"160921-131242-jeorse.csv",0,0,0,0,0,0,1,"DataOne",1,0,0,1
"160921-144900-jeorse.csv",0,0,0,0,0,0,1,"DataOne",1,0,0,1
"160921-162334-jeorse.csv",0,0,0,0,0,0,1,"DataOne",1,0,0,1
"160922-075450-63rdstreet.csv",0,0,0,0,0,0,1,"DataOne",1,0,0,1
"17 or 24",0,0,0,0,0,0,1,"DataOne",1,0,0,1
"17_fort_peck",0,0,0,0,0,0,1,"DataOne",1,0,0,1
"17a",0,0,0,0,0,0,1,"DataOne",1,0,0,1
"17b",0,0,0,0,0,0,1,"DataOne",1,0,0,1
"17c",0,0,0,0,0,0,1,"DataOne",1,0,0,1
"17d",0,0,0,0,0,0,1,"DataOne",1,0,0,1
"180",0,0,0,0,0,0,1,"DataOne",1,0,0,1
"1934",0,0,0,0,0,0,1,"DataOne",1,0,0,1
"1935",0,0,0,0,0,0,1,"DataOne",1,0,0,1
"196407",0,0,0,0,0,0,1,"DataOne",1,0,0,1
"1970s",0,0,0,0,0,0,1,"DataOne",1,0,0,1
"19850906",0,0,0,0,0,0,1,"DataOne",1,0,0,1
"19850928",0,0,0,0,0,0,1,"DataOne",1,0,0,1
"19851003",0,0,0,0,0,0,1,"DataOne",1,0,0,1
"19851021",0,0,0,0,0,0,1,"DataOne",1,0,0,1
"1996 cir aerial",0,0,0,0,0,0,1,"DataOne",1,0,0,1
"1a",0,0,0,0,0,0,1,"DataOne",1,0,0,1
"1b",0,0,0,0,0,0,1,"DataOne",1,0,0,1
"1c",0,0,0,0,0,0,1,"DataOne",1,0,0,1
"1mfs",0,0,0,0,0,0,1,"DataOne",1,0,0,1
"1r",0,0,0,0,0,0,1,"DataOne",1,0,0,1
"1t",0,0,0,0,0,0,1,"DataOne",1,0,0,1
"2",0,0,0,0,0,0,1,"DataOne",1,0,0,1
"2.0-snapshot",0,0,0,0,0,0,1,"DataOne",1,0,0,1
"2.1",0,0,0,0,0,0,1,"DataOne",1,0,0,1
"2.2",0,0,0,0,0,0,1,"DataOne",1,0,0,1
"2.3",0,0,0,0,0,0,1,"DataOne",1,0,0,1
"2.5% (quantile)",0,0,0,0,0,0,1,"DataOne",1,0,0,1
"2.8",0,0,0,0,0,0,1,"DataOne",1,0,0,1
"2.b.6.d030.m069.g112",0,0,0,0,0,0,1,"DataOne",1,0,0,1
"2.b.6.d030.m303.g556",0,0,0,0,0,0,1,"DataOne",1,0,0,1
"2_grand",0,0,0,0,0,0,1,"DataOne",1,0,0,1
"20 min - cumulative values",0,0,0,0,0,0,1,"DataOne",1,0,0,1
"200",0,0,0,0,0,0,1,"DataOne",1,0,0,1
"201",0,0,0,0,0,0,1,"DataOne",1,0,0,1
"2010-033-fa",0,0,0,0,0,0,1,"DataOne",1,0,0,1
"2013 2014",0,0,0,0,0,0,1,"DataOne",1,0,0,1
"2014-046-fa",0,0,0,0,0,0,1,"DataOne",1,0,0,1
"2015",0,0,0,0,0,0,1,"DataOne",1,0,0,1
"20150901_085553_jeorse_beachdetail1_iver2-57.log",0,0,0,0,0,0,1,"DataOne",1,0,0,1
"20150901_135114_jeorse_longundulations1_iver2-57_corr_edited.log",0,0,0,0,0,0,1,"DataOne",1,0,0,1
"20150901_152255_jeorse_longundulations3_iver2-57_corr.log",0,0,0,0,0,0,1,"DataOne",1,0,0,1
"20150901_170345_jeorse_longundulations2_iver2-57_edited.log",0,0,0,0,0,0,1,"DataOne",1,0,0,1
"20150902_102321_63rd_beachdetail1_wbreakwall_iver2-57_corr_edited.log",0,0,0,0,0,0,1,"DataOne",1,0,0,1
"20150902_124736_63rd_beachdetail1_wbreakwall_startatline8_iver2-57_corr_edited2.log",0,0,0,0,0,0,1,"DataOne",1,0,0,1
"20160921_082307_jeorse_beachdetail1_iver2-57edited.log",0,0,0,0,0,0,1,"DataOne",1,0,0,1
"20160921_131508_jeorse_longundulations1_iver2-57.log",0,0,0,0,0,0,1,"DataOne",1,0,0,1
"20160921_145110_jeorse_longundulations3_iver2-57.log",0,0,0,0,0,0,1,"DataOne",1,0,0,1
"20160921_162451_jeorse_longundulations2_iver2-57edited.log",0,0,0,0,0,0,1,"DataOne",1,0,0,1
"20160922_100718_63rd_beachdetail1_wbreakwallend_iver2-57.log",0,0,0,0,0,0,1,"DataOne",1,0,0,1
"20455",0,0,0,0,0,0,1,"DataOne",1,0,0,1
"205",0,0,0,0,0,0,1,"DataOne",1,0,0,1
"209",0,0,0,0,0,0,1,"DataOne",1,0,0,1
"21.6189058615",0,0,0,0,0,0,1,"DataOne",1,0,0,1
"210",0,0,0,0,0,0,1,"DataOne",1,0,0,1
"21010002",0,0,0,0,0,0,1,"DataOne",1,0,0,1
"21010003",0,0,0,0,0,0,1,"DataOne",1,0,0,1
"21010004",0,0,0,0,0,0,1,"DataOne",1,0,0,1
"21010005",0,0,0,0,0,0,1,"DataOne",1,0,0,1
"2172025",0,0,0,0,0,0,1,"DataOne",1,0,0,1
"2172060",0,0,0,0,0,0,1,"DataOne",1,0,0,1
"217206110",0,0,0,0,0,0,1,"DataOne",1,0,0,1
"217206147",0,0,0,0,0,0,1,"DataOne",1,0,0,1
"2172062",0,0,0,0,0,0,1,"DataOne",1,0,0,1
"22",0,0,0,0,0,0,1,"DataOne",1,0,0,1
"22.6",0,0,0,0,0,0,1,"DataOne",1,0,0,1
"224",0,0,0,0,0,0,1,"DataOne",1,0,0,1
"226",0,0,0,0,0,0,1,"DataOne",1,0,0,1
"23",0,0,0,0,0,0,1,"DataOne",1,0,0,1
"233",0,0,0,0,0,0,1,"DataOne",1,0,0,1
"23651",0,0,0,0,0,0,1,"DataOne",1,0,0,1
"24000",0,0,0,0,0,0,1,"DataOne",1,0,0,1
"247",0,0,0,0,0,0,1,"DataOne",1,0,0,1
"248",0,0,0,0,0,0,1,"DataOne",1,0,0,1
"25",0,0,0,0,0,0,1,"DataOne",1,0,0,1
"25% (quartile)",0,0,0,0,0,0,1,"DataOne",1,0,0,1
"250 ms",0,0,0,0,0,0,1,"DataOne",1,0,0,1
"25000",0,0,0,0,0,0,1,"DataOne",1,0,0,1
"254",0,0,0,0,0,0,1,"DataOne",1,0,0,1
"256",0,0,0,0,0,0,1,"DataOne",1,0,0,1
"259",0,0,0,0,0,0,1,"DataOne",1,0,0,1
"28",0,0,0,0,0,0,1,"DataOne",1,0,0,1
"29.1",0,0,0,0,0,0,1,"DataOne",1,0,0,1
"29860",0,0,0,0,0,0,1,"DataOne",1,0,0,1
"2a",0,0,0,0,0,0,1,"DataOne",1,0,0,1
"2b",0,0,0,0,0,0,1,"DataOne",1,0,0,1
"2c",0,0,0,0,0,0,1,"DataOne",1,0,0,1
"2mfs",0,0,0,0,0,0,1,"DataOne",1,0,0,1
"2r",0,0,0,0,0,0,1,"DataOne",1,0,0,1
"2t",0,0,0,0,0,0,1,"DataOne",1,0,0,1
"3",0,0,0,0,0,0,1,"DataOne",1,0,0,1
"3.1",0,0,0,0,0,0,1,"DataOne",1,0,0,1
"3.2",0,0,0,0,0,0,1,"DataOne",1,0,0,1
"3/4 meter plankton ne",0,0,0,0,0,0,1,"DataOne",1,0,0,1
"3_kansas",0,0,0,0,0,0,1,"DataOne",1,0,0,1
"3044",0,0,0,0,0,0,1,"DataOne",1,0,0,1
"3058",0,0,0,0,0,0,1,"DataOne",1,0,0,1
"3060",0,0,0,0,0,0,1,"DataOne",1,0,0,1
"3070",0,0,0,0,0,0,1,"DataOne",1,0,0,1
"3071",0,0,0,0,0,0,1,"DataOne",1,0,0,1
"312",0,0,0,0,0,0,1,"DataOne",1,0,0,1
"32",0,0,0,0,0,0,1,"DataOne",1,0,0,1
"33-66 percent",0,0,0,0,0,0,1,"DataOne",1,0,0,1
"330019079561500",0,0,0,0,0,0,1,"DataOne",1,0,0,1
"330139079570800",0,0,0,0,0,0,1,"DataOne",1,0,0,1
"33511",0,0,0,0,0,0,1,"DataOne",1,0,0,1
"33512",0,0,0,0,0,0,1,"DataOne",1,0,0,1
"3371650",0,0,0,0,0,0,1,"DataOne",1,0,0,1
"3375500",0,0,0,0,0,0,1,"DataOne",1,0,0,1
"36",0,0,0,0,0,0,1,"DataOne",1,0,0,1
"360",0,0,0,0,0,0,1,"DataOne",1,0,0,1
"37164",0,0,0,0,0,0,1,"DataOne",1,0,0,1
"3a",0,0,0,0,0,0,1,"DataOne",1,0,0,1
"3b",0,0,0,0,0,0,1,"DataOne",1,0,0,1
"3c",0,0,0,0,0,0,1,"DataOne",1,0,0,1
"3mfs",0,0,0,0,0,0,1,"DataOne",1,0,0,1
"3r",0,0,0,0,0,0,1,"DataOne",1,0,0,1
"3stgshelter",0,0,0,0,0,0,1,"DataOne",1,0,0,1
"3t",0,0,0,0,0,0,1,"DataOne",1,0,0,1
"4 or 5",0,0,0,0,0,0,1,"DataOne",1,0,0,1
"4_platte",0,0,0,0,0,0,1,"DataOne",1,0,0,1
"4015",0,0,0,0,0,0,1,"DataOne",1,0,0,1
"406",0,0,0,0,0,0,1,"DataOne",1,0,0,1
"412",0,0,0,0,0,0,1,"DataOne",1,0,0,1
"414",0,0,0,0,0,0,1,"DataOne",1,0,0,1
"41548",0,0,0,0,0,0,1,"DataOne",1,0,0,1
"41761",0,0,0,0,0,0,1,"DataOne",1,0,0,1
"41796",0,0,0,0,0,0,1,"DataOne",1,0,0,1
"41912",0,0,0,0,0,0,1,"DataOne",1,0,0,1
"421",0,0,0,0,0,0,1,"DataOne",1,0,0,1
"42598",0,0,0,0,0,0,1,"DataOne",1,0,0,1
"42599",0,0,0,0,0,0,1,"DataOne",1,0,0,1
"42789",0,0,0,0,0,0,1,"DataOne",1,0,0,1
"43.831",0,0,0,0,0,0,1,"DataOne",1,0,0,1
"44.004",0,0,0,0,0,0,1,"DataOne",1,0,0,1
"45",0,0,0,0,0,0,1,"DataOne",1,0,0,1
"453356122172100",0,0,0,0,0,0,1,"DataOne",1,0,0,1
"453833121061600",0,0,0,0,0,0,1,"DataOne",1,0,0,1
"47",0,0,0,0,0,0,1,"DataOne",1,0,0,1
"48000",0,0,0,0,0,0,1,"DataOne",1,0,0,1
"4a",0,0,0,0,0,0,1,"DataOne",1,0,0,1
"4b",0,0,0,0,0,0,1,"DataOne",1,0,0,1
"4c",0,0,0,0,0,0,1,"DataOne",1,0,0,1
"4mfs",0,0,0,0,0,0,1,"DataOne",1,0,0,1
"4r",0,0,0,0,0,0,1,"DataOne",1,0,0,1
"4t",0,0,0,0,0,0,1,"DataOne",1,0,0,1
"5",0,0,0,0,0,0,1,"DataOne",1,0,0,1
"5.6",0,0,0,0,0,0,1,"DataOne",1,0,0,1
"5_sioux",0,0,0,0,0,0,1,"DataOne",1,0,0,1
"50% (median)",0,0,0,0,0,0,1,"DataOne",1,0,0,1
"5005",0,0,0,0,0,0,1,"DataOne",1,0,0,1
"52",0,0,0,0,0,0,1,"DataOne",1,0,0,1
"54",0,0,0,0,0,0,1,"DataOne",1,0,0,1
"56",0,0,0,0,0,0,1,"DataOne",1,0,0,1
"59",0,0,0,0,0,0,1,"DataOne",1,0,0,1
"5a",0,0,0,0,0,0,1,"DataOne",1,0,0,1
"5a",0,0,0,0,0,0,1,"DataOne",1,0,0,1
"5b",0,0,0,0,0,0,1,"DataOne",1,0,0,1
"5c",0,0,0,0,0,0,1,"DataOne",1,0,0,1
"5mfs",0,0,0,0,0,0,1,"DataOne",1,0,0,1
"5r",0,0,0,0,0,0,1,"DataOne",1,0,0,1
"5t",0,0,0,0,0,0,1,"DataOne",1,0,0,1
"5yrselect",0,0,0,0,0,0,1,"DataOne",1,0,0,1
"6",0,0,0,0,0,0,1,"DataOne",1,0,0,1
"6-step semi-quant emission spec",0,0,0,0,0,0,1,"DataOne",1,0,0,1
"6_ponca",0,0,0,0,0,0,1,"DataOne",1,0,0,1
"60",0,0,0,0,0,0,1,"DataOne",1,0,0,1
"6018",0,0,0,0,0,0,1,"DataOne",1,0,0,1
"61",0,0,0,0,0,0,1,"DataOne",1,0,0,1
"610",0,0,0,0,0,0,1,"DataOne",1,0,0,1
"616",0,0,0,0,0,0,1,"DataOne",1,0,0,1
"619",0,0,0,0,0,0,1,"DataOne",1,0,0,1
"6211",0,0,0,0,0,0,1,"DataOne",1,0,0,1
"625",0,0,0,0,0,0,1,"DataOne",1,0,0,1
"62500",0,0,0,0,0,0,1,"DataOne",1,0,0,1
"63.121782074",0,0,0,0,0,0,1,"DataOne",1,0,0,1
"64",0,0,0,0,0,0,1,"DataOne",1,0,0,1
"64.936261",0,0,0,0,0,0,1,"DataOne",1,0,0,1
"66-90 percent",0,0,0,0,0,0,1,"DataOne",1,0,0,1
"7'30""",0,0,0,0,0,0,1,"DataOne",1,0,0,1
"7_gavins",0,0,0,0,0,0,1,"DataOne",1,0,0,1
"70",0,0,0,0,0,0,1,"DataOne",1,0,0,1
"707.47",0,0,0,0,0,0,1,"DataOne",1,0,0,1
"71",0,0,0,0,0,0,1,"DataOne",1,0,0,1
"75% (quartile)",0,0,0,0,0,0,1,"DataOne",1,0,0,1
"8",0,0,0,0,0,0,1,"DataOne",1,0,0,1
"8",0,0,0,0,0,0,1,"DataOne",1,0,0,1
"8/20-30/1957",0,0,0,0,0,0,1,"DataOne",1,0,0,1
"80",0,0,0,0,0,0,1,"DataOne",1,0,0,1
"81",0,0,0,0,0,0,1,"DataOne",1,0,0,1
"836540845",0,0,0,0,0,0,1,"DataOne",1,0,0,1
"9",0,0,0,0,0,0,1,"DataOne",1,0,0,1
"90",0,0,0,0,0,0,1,"DataOne",1,0,0,1
"90",0,0,0,0,0,0,1,"DataOne",1,0,0,1
"90% (quantile)",0,0,0,0,0,0,1,"DataOne",1,0,0,1
"91",0,0,0,0,0,0,1,"DataOne",1,0,0,1
"97.5% (quantile)",0,0,0,0,0,0,1,"DataOne",1,0,0,1
"99.5% (quantile)",0,0,0,0,0,0,1,"DataOne",1,0,0,1
"â°c",0,0,0,0,0,0,1,"DataOne",1,0,0,1
"âµg-1 l-1",0,0,0,0,0,0,1,"DataOne",1,0,0,1
"âµg cm-2",0,0,0,0,0,0,1,"DataOne",1,0,0,1
"âµm",0,0,0,0,0,0,1,"DataOne",1,0,0,1
"a1",0,0,0,0,0,0,1,"DataOne",1,0,0,1
"a2",0,0,0,0,0,0,1,"DataOne",1,0,0,1
"a3",0,0,0,0,0,0,1,"DataOne",1,0,0,1
"a4",0,0,0,0,0,0,1,"DataOne",1,0,0,1
"a80_6_1minnav_sort",0,0,0,0,0,0,1,"DataOne",1,0,0,1
"aa_acid",0,0,0,0,0,0,1,"DataOne",1,0,0,1
"aa_ar_p",0,0,0,0,0,0,1,"DataOne",1,0,0,1
"aa_cv_wo",0,0,0,0,0,0,1,"DataOne",1,0,0,1
"aa_f",0,0,0,0,0,0,1,"DataOne",1,0,0,1
"aa_f_az_fuse_p",0,0,0,0,0,0,1,"DataOne",1,0,0,1
"aa_f_az_h2o2_p",0,0,0,0,0,0,1,"DataOne",1,0,0,1
"aa_f_az_hcl_p",0,0,0,0,0,0,1,"DataOne",1,0,0,1
"aa_f_dtpa_p",0,0,0,0,0,0,1,"DataOne",1,0,0,1
"aa_f_fuse",0,0,0,0,0,0,1,"DataOne",1,0,0,1
"aa_f_fuse_p",0,0,0,0,0,0,1,"DataOne",1,0,0,1
"aa_f_hbr",0,0,0,0,0,0,1,"DataOne",1,0,0,1
"aa_f_hcl_p",0,0,0,0,0,0,1,"DataOne",1,0,0,1
"aa_f_hf",0,0,0,0,0,0,1,"DataOne",1,0,0,1
"aa_f_hno3_p",0,0,0,0,0,0,1,"DataOne",1,0,0,1
"aa_fe",0,0,0,0,0,0,1,"DataOne",1,0,0,1
"aa_fe_hf",0,0,0,0,0,0,1,"DataOne",1,0,0,1
"aa_fuse",0,0,0,0,0,0,1,"DataOne",1,0,0,1
"aa_gf",0,0,0,0,0,0,1,"DataOne",1,0,0,1
"aa_gf_ae",0,0,0,0,0,0,1,"DataOne",1,0,0,1
"aa_gf_ar",0,0,0,0,0,0,1,"DataOne",1,0,0,1
"aa_gf_hf",0,0,0,0,0,0,1,"DataOne",1,0,0,1
"aa_gf_hf2",0,0,0,0,0,0,1,"DataOne",1,0,0,1
"aa_gf_st",0,0,0,0,0,0,1,"DataOne",1,0,0,1
"aa_hf",0,0,0,0,0,0,1,"DataOne",1,0,0,1
"aa_hg",0,0,0,0,0,0,1,"DataOne",1,0,0,1
"aa_hg_acid",0,0,0,0,0,0,1,"DataOne",1,0,0,1
"aa_hg_ar",0,0,0,0,0,0,1,"DataOne",1,0,0,1
"aa_hg_hf",0,0,0,0,0,0,1,"DataOne",1,0,0,1
"aa_hg_st",0,0,0,0,0,0,1,"DataOne",1,0,0,1
"aa_kbrf4",0,0,0,0,0,0,1,"DataOne",1,0,0,1
"aa_st",0,0,0,0,0,0,1,"DataOne",1,0,0,1
"aa_tr",0,0,0,0,0,0,1,"DataOne",1,0,0,1
"aa1",0,0,0,0,0,0,1,"DataOne",1,0,0,1
"aa11",0,0,0,0,0,0,1,"DataOne",1,0,0,1
"aa12",0,0,0,0,0,0,1,"DataOne",1,0,0,1
"aa16",0,0,0,0,0,0,1,"DataOne",1,0,0,1
"aa19",0,0,0,0,0,0,1,"DataOne",1,0,0,1
"aa2",0,0,0,0,0,0,1,"DataOne",1,0,0,1
"aa21",0,0,0,0,0,0,1,"DataOne",1,0,0,1
"aa23",0,0,0,0,0,0,1,"DataOne",1,0,0,1
"aa28",0,0,0,0,0,0,1,"DataOne",1,0,0,1
"aa29",0,0,0,0,0,0,1,"DataOne",1,0,0,1
"aa3",0,0,0,0,0,0,1,"DataOne",1,0,0,1
"aa31",0,0,0,0,0,0,1,"DataOne",1,0,0,1
"aa7",0,0,0,0,0,0,1,"DataOne",1,0,0,1
"aa8",0,0,0,0,0,0,1,"DataOne",1,0,0,1
"aarch",0,0,0,0,0,0,1,"DataOne",1,0,0,1
"ab",0,0,0,0,0,0,1,"DataOne",1,0,0,1
"ab13",0,0,0,0,0,0,1,"DataOne",1,0,0,1
"ab14",0,0,0,0,0,0,1,"DataOne",1,0,0,1
"ab2",0,0,0,0,0,0,1,"DataOne",1,0,0,1
"abandoned well pad",0,0,0,0,0,0,1,"DataOne",1,0,0,1
"abel j",0,0,0,0,0,0,1,"DataOne",1,0,0,1
"abf",0,0,0,0,0,0,1,"DataOne",1,0,0,1
"ac",0,0,0,0,0,0,1,"DataOne",1,0,0,1
"accipitriformes",0,0,0,0,0,0,1,"DataOne",1,0,0,1
"acepd well_name listed in otid",0,0,0,0,0,0,1,"DataOne",1,0,0,1
"acepd_may2010_data",0,0,0,0,0,0,1,"DataOne",1,0,0,1
"acipenser brevirostrum",0,0,0,0,0,0,1,"DataOne",1,0,0,1
"ackerman",0,0,0,0,0,0,1,"DataOne",1,0,0,1
"ad",0,0,0,0,0,0,1,"DataOne",1,0,0,1
"adit",0,0,0,0,0,0,1,"DataOne",1,0,0,1
"adjusting",0,0,0,0,0,0,1,"DataOne",1,0,0,1
"aes_ar_p",0,0,0,0,0,0,1,"DataOne",1,0,0,1
"aes_fuse",0,0,0,0,0,0,1,"DataOne",1,0,0,1
"aes_fuse_ree",0,0,0,0,0,0,1,"DataOne",1,0,0,1
"aes_hf",0,0,0,0,0,0,1,"DataOne",1,0,0,1
"aes_hf_ree",0,0,0,0,0,0,1,"DataOne",1,0,0,1
"aes_hno3_p",0,0,0,0,0,0,1,"DataOne",1,0,0,1
"aes_ie",0,0,0,0,0,0,1,"DataOne",1,0,0,1
"aes_kclo3_p",0,0,0,0,0,0,1,"DataOne",1,0,0,1
"ag",0,0,0,0,0,0,1,"DataOne",1,0,0,1
"ag_ppm_aes_az_p",0,0,0,0,0,0,1,"DataOne",1,0,0,1
"ag_ppm_es_sq",0,0,0,0,0,0,1,"DataOne",1,0,0,1
"ag_ppm_ms_st",0,0,0,0,0,0,1,"DataOne",1,0,0,1
"aga1",0,0,0,0,0,0,1,"DataOne",1,0,0,1
"aga2",0,0,0,0,0,0,1,"DataOne",1,0,0,1
"agab",0,0,0,0,0,0,1,"DataOne",1,0,0,1
"agat",0,0,0,0,0,0,1,"DataOne",1,0,0,1
"agb1",0,0,0,0,0,0,1,"DataOne",1,0,0,1
"agb2",0,0,0,0,0,0,1,"DataOne",1,0,0,1
"agc1",0,0,0,0,0,0,1,"DataOne",1,0,0,1
"agd1",0,0,0,0,0,0,1,"DataOne",1,0,0,1
"agd2",0,0,0,0,0,0,1,"DataOne",1,0,0,1
"age_1",0,0,0,0,0,0,1,"DataOne",1,0,0,1
"age_2+",0,0,0,0,0,0,1,"DataOne",1,0,0,1
"aggregate",0,0,0,0,0,0,1,"DataOne",1,0,0,1
"agwt",0,0,0,0,0,0,1,"DataOne",1,0,0,1
"ai change per year",0,0,0,0,0,0,1,"DataOne",1,0,0,1
"aialik cape",0,0,0,0,0,0,1,"DataOne",1,0,0,1
"air",0,0,0,0,0,0,1,"DataOne",1,0,0,1
"air photo",0,0,0,0,0,0,1,"DataOne",1,0,0,1
"air photos",0,0,0,0,0,0,1,"DataOne",1,0,0,1
"air shaft",0,0,0,0,0,0,1,"DataOne",1,0,0,1
"air temp",0,0,0,0,0,0,1,"DataOne",1,0,0,1
"ak standard time - hh:mm",0,0,0,0,0,0,1,"DataOne",1,0,0,1
"ak,cn",0,0,0,0,0,0,1,"DataOne",1,0,0,1
"al",0,0,0,0,0,0,1,"DataOne",1,0,0,1
"al-wy",0,0,0,0,0,0,1,"DataOne",1,0,0,1
"al_pct_aes_st",0,0,0,0,0,0,1,"DataOne",1,0,0,1
"al_pct_wdx_fuse",0,0,0,0,0,0,1,"DataOne",1,0,0,1
"al2o3",0,0,0,0,0,0,1,"DataOne",1,0,0,1
"al2o3_pct_wdx_fuse",0,0,0,0,0,0,1,"DataOne",1,0,0,1
"alaskite",0,0,0,0,0,0,1,"DataOne",1,0,0,1
"albatross iv",0,0,0,0,0,0,1,"DataOne",1,0,0,1
"albatrossiii",0,0,0,0,0,0,1,"DataOne",1,0,0,1
"alberta",0,0,0,0,0,0,1,"DataOne",1,0,0,1
"alexander archipelago",0,0,0,0,0,0,1,"DataOne",1,0,0,1
"algae",0,0,0,0,0,0,1,"DataOne",1,0,0,1
"algae and submergent macrophytes",0,0,0,0,0,0,1,"DataOne",1,0,0,1
"alive",0,0,0,0,0,0,1,"DataOne",1,0,0,1
"alkali",0,0,0,0,0,0,1,"DataOne",1,0,0,1
"all other values not defined above",0,0,0,0,0,0,1,"DataOne",1,0,0,1
"alluvial",0,0,0,0,0,0,1,"DataOne",1,0,0,1
"alluvial fan",0,0,0,0,0,0,1,"DataOne",1,0,0,1
"alpe4",0,0,0,0,0,0,1,"DataOne",1,0,0,1
"alpha",0,0,0,0,0,0,1,"DataOne",1,0,0,1
"alpha & omega ii",0,0,0,0,0,0,1,"DataOne",1,0,0,1
"alphanumeric",0,0,0,0,0,0,1,"DataOne",1,0,0,1
"alvin push core",0,0,0,0,0,0,1,"DataOne",1,0,0,1
"alyce c",0,0,0,0,0,0,1,"DataOne",1,0,0,1
"am",0,0,0,0,0,0,1,"DataOne",1,0,0,1
"amat island",0,0,0,0,0,0,1,"DataOne",1,0,0,1
"ambient laboratory van: lv01",0,0,0,0,0,0,1,"DataOne",1,0,0,1
"ambloplites rupestris",0,0,0,0,0,0,1,"DataOne",1,0,0,1
"amchitka island",0,0,0,0,0,0,1,"DataOne",1,0,0,1
"amcor refridgerated van: re01",0,0,0,0,0,0,1,"DataOne",1,0,0,1
"american eel",0,0,0,0,0,0,1,"DataOne",1,0,0,1
"american elm",0,0,0,0,0,0,1,"DataOne",1,0,0,1
"american holly",0,0,0,0,0,0,1,"DataOne",1,0,0,1
"american hornbeam",0,0,0,0,0,0,1,"DataOne",1,0,0,1
"ammodytes hexapterus",0,0,0,0,0,0,1,"DataOne",1,0,0,1
"amnh",0,0,0,0,0,0,1,"DataOne",1,0,0,1
"amphibolite",0,0,0,0,0,0,1,"DataOne",1,0,0,1
"amphipod",0,0,0,0,0,0,1,"DataOne",1,0,0,1
"amphipoda",0,0,0,0,0,0,1,"DataOne",1,0,0,1
"amwi",0,0,0,0,0,0,1,"DataOne",1,0,0,1
"anan1971",0,0,0,0,0,0,1,"DataOne",1,0,0,1
"anatum",0,0,0,0,0,0,1,"DataOne",1,0,0,1
"anatum/pealei?",0,0,0,0,0,0,1,"DataOne",1,0,0,1
"anatum/tundrius?",0,0,0,0,0,0,1,"DataOne",1,0,0,1
"anchor dredg",0,0,0,0,0,0,1,"DataOne",1,0,0,1
"anchor scar",0,0,0,0,0,0,1,"DataOne",1,0,0,1
"anderson",0,0,0,0,0,0,1,"DataOne",1,0,0,1
"andr",0,0,0,0,0,0,1,"DataOne",1,0,0,1
"andr95015",0,0,0,0,0,0,1,"DataOne",1,0,0,1
"andr95036",0,0,0,0,0,0,1,"DataOne",1,0,0,1
"andrews",0,0,0,0,0,0,1,"DataOne",1,0,0,1
"anerkochik river 1",0,0,0,0,0,0,1,"DataOne",1,0,0,1
"anerkochik river 2",0,0,0,0,0,0,1,"DataOne",1,0,0,1
"anerkochik river 3",0,0,0,0,0,0,1,"DataOne",1,0,0,1
"anerkochik river 4",0,0,0,0,0,0,1,"DataOne",1,0,0,1
"anguilla rostrata",0,0,0,0,0,0,1,"DataOne",1,0,0,1
"annandale",0,0,0,0,0,0,1,"DataOne",1,0,0,1
"annelida",0,0,0,0,0,0,1,"DataOne",1,0,0,1
"anostraca",0,0,0,0,0,0,1,"DataOne",1,0,0,1
"anseriformes",0,0,0,0,0,0,1,"DataOne",1,0,0,1
"ansp",0,0,0,0,0,0,1,"DataOne",1,0,0,1
"anthracite",0,0,0,0,0,0,1,"DataOne",1,0,0,1
"apc",0,0,0,0,0,0,1,"DataOne",1,0,0,1
"api (radioactive units)",0,0,0,0,0,0,1,"DataOne",1,0,0,1
"api (radioactivity units)",0,0,0,0,0,0,1,"DataOne",1,0,0,1
"api (unit of radioactivity)",0,0,0,0,0,0,1,"DataOne",1,0,0,1
"apodiformes",0,0,0,0,0,0,1,"DataOne",1,0,0,1
"apr",0,0,0,0,0,0,1,"DataOne",1,0,0,1
"aquatic",0,0,0,0,0,0,1,"DataOne",1,0,0,1
"araneae",0,0,0,0,0,0,1,"DataOne",1,0,0,1
"arctic char",0,0,0,0,0,0,1,"DataOne",1,0,0,1
"arcuate bands",0,0,0,0,0,0,1,"DataOne",1,0,0,1
"ard",0,0,0,0,0,0,1,"DataOne",1,0,0,1
"aremp",0,0,0,0,0,0,1,"DataOne",1,0,0,1
"argo maine",0,0,0,0,0,0,1,"DataOne",1,0,0,1
"argo94014",0,0,0,0,0,0,1,"DataOne",1,0,0,1
"arizona 1",0,0,0,0,0,0,1,"DataOne",1,0,0,1
"armstrong1974",0,0,0,0,0,0,1,"DataOne",1,0,0,1
"arrowwood",0,0,0,0,0,0,1,"DataOne",1,0,0,1
"art",0,0,0,0,0,0,1,"DataOne",1,0,0,1
"arthropoda",0,0,0,0,0,0,1,"DataOne",1,0,0,1
"as",0,0,0,0,0,0,1,"DataOne",1,0,0,1
"as_ppm_aes_az_p",0,0,0,0,0,0,1,"DataOne",1,0,0,1
"as_ppm_es_sq",0,0,0,0,0,0,1,"DataOne",1,0,0,1
"as_ppm_ms_st",0,0,0,0,0,0,1,"DataOne",1,0,0,1
"as_ppm_na_lc",0,0,0,0,0,0,1,"DataOne",1,0,0,1
"ash",0,0,0,0,0,0,1,"DataOne",1,0,0,1
"ash",0,0,0,0,0,0,1,"DataOne",1,0,0,1
"associated disturbance",0,0,0,0,0,0,1,"DataOne",1,0,0,1
"ast-80-6b",0,0,0,0,0,0,1,"DataOne",1,0,0,1
"aster",0,0,0,0,0,0,1,"DataOne",1,0,0,1
"astr-80-6b",0,0,0,0,0,0,1,"DataOne",1,0,0,1
"astr75-june",0,0,0,0,0,0,1,"DataOne",1,0,0,1
"atlantic salmon",0,0,0,0,0,0,1,"DataOne",1,0,0,1
"atlantic surveyor",0,0,0,0,0,0,1,"DataOne",1,0,0,1
"atlantic twin",0,0,0,0,0,0,1,"DataOne",1,0,0,1
"atlantis ii/alvin",0,0,0,0,0,0,1,"DataOne",1,0,0,1
"atlantis/alvin",0,0,0,0,0,0,1,"DataOne",1,0,0,1
"atlrim",0,0,0,0,0,0,1,"DataOne",1,0,0,1
"atmospheres of pressure",0,0,0,0,0,0,1,"DataOne",1,0,0,1
"attu island",0,0,0,0,0,0,1,"DataOne",1,0,0,1
"aty",0,0,0,0,0,0,1,"DataOne",1,0,0,1
"au",0,0,0,0,0,0,1,"DataOne",1,0,0,1
"au_ppm_aa_gf_hbr",0,0,0,0,0,0,1,"DataOne",1,0,0,1
"au_ppm_aes_az_p",0,0,0,0,0,0,1,"DataOne",1,0,0,1
"au_ppm_es_sq",0,0,0,0,0,0,1,"DataOne",1,0,0,1
"au_ppm_fa_ms",0,0,0,0,0,0,1,"DataOne",1,0,0,1
"au_ppm_na_lc",0,0,0,0,0,0,1,"DataOne",1,0,0,1
"au_ppm_na_sc",0,0,0,0,0,0,1,"DataOne",1,0,0,1
"auchenorrhyncha",0,0,0,0,0,0,1,"DataOne",1,0,0,1
"aug",0,0,0,0,0,0,1,"DataOne",1,0,0,1
"aum",0,0,0,0,0,0,1,"DataOne",1,0,0,1
"author defined.",0,0,0,0,0,0,1,"DataOne",1,0,0,1
"autumn 2012",0,0,0,0,0,0,1,"DataOne",1,0,0,1
"autumn 2013",0,0,0,0,0,0,1,"DataOne",1,0,0,1
"average percent cover",0,0,0,0,0,0,1,"DataOne",1,0,0,1
"average percent shrub cover",0,0,0,0,0,0,1,"DataOne",1,0,0,1
"avg240",0,0,0,0,0,0,1,"DataOne",1,0,0,1
"avg30",0,0,0,0,0,0,1,"DataOne",1,0,0,1
"avgtemp",0,0,0,0,0,0,1,"DataOne",1,0,0,1
"ayby",0,0,0,0,0,0,1,"DataOne",1,0,0,1
"b_ppm_aes_st",0,0,0,0,0,0,1,"DataOne",1,0,0,1
"b_ppm_es_sq",0,0,0,0,0,0,1,"DataOne",1,0,0,1
"b1",0,0,0,0,0,0,1,"DataOne",1,0,0,1
"b2",0,0,0,0,0,0,1,"DataOne",1,0,0,1
"b3",0,0,0,0,0,0,1,"DataOne",1,0,0,1
"b4",0,0,0,0,0,0,1,"DataOne",1,0,0,1
"ba",0,0,0,0,0,0,1,"DataOne",1,0,0,1
"ba_ppm_aes_st",0,0,0,0,0,0,1,"DataOne",1,0,0,1
"ba_ppm_edx",0,0,0,0,0,0,1,"DataOne",1,0,0,1
"ba_ppm_es_sq",0,0,0,0,0,0,1,"DataOne",1,0,0,1
"ba_ppm_na_lc",0,0,0,0,0,0,1,"DataOne",1,0,0,1
"ba_ppm_na_sc",0,0,0,0,0,0,1,"DataOne",1,0,0,1
"ba_ppm_wdx_fuse",0,0,0,0,0,0,1,"DataOne",1,0,0,1
"bab",0,0,0,0,0,0,1,"DataOne",1,0,0,1
"backshore",0,0,0,0,0,0,1,"DataOne",1,0,0,1
"bacterial plasmid",0,0,0,0,0,0,1,"DataOne",1,0,0,1
"baetidae",0,0,0,0,0,0,1,"DataOne",1,0,0,1
"baits / hectare",0,0,0,0,0,0,1,"DataOne",1,0,0,1
"bald head chris",0,0,0,0,0,0,1,"DataOne",1,0,0,1
"baldcypress",0,0,0,0,0,0,1,"DataOne",1,0,0,1
"ball mountain",0,0,0,0,0,0,1,"DataOne",1,0,0,1
"band number",0,0,0,0,0,0,1,"DataOne",1,0,0,1
"banded darter",0,0,0,0,0,0,1,"DataOne",1,0,0,1
"banded killifish",0,0,0,0,0,0,1,"DataOne",1,0,0,1
"banding date",0,0,0,0,0,0,1,"DataOne",1,0,0,1
"bans",0,0,0,0,0,0,1,"DataOne",1,0,0,1
"bar side slope",0,0,0,0,0,0,1,"DataOne",1,0,0,1
"bar top",0,0,0,0,0,0,1,"DataOne",1,0,0,1
"barchanoid sand waves",0,0,0,0,0,0,1,"DataOne",1,0,0,1
"barchanoid sand waves",0,0,0,0,0,0,1,"DataOne",1,0,0,1
"barren",0,0,0,0,0,0,1,"DataOne",1,0,0,1
"barrier_interior",0,0,0,0,0,0,1,"DataOne",1,0,0,1
"barrierinterior",0,0,0,0,0,0,1,"DataOne",1,0,0,1
"basalt",0,0,0,0,0,0,1,"DataOne",1,0,0,1
"base",0,0,0,0,0,0,1,"DataOne",1,0,0,1
"baseline",0,0,0,0,0,0,1,"DataOne",1,0,0,1
"bbm",0,0,0,0,0,0,1,"DataOne",1,0,0,1
"bbpl",0,0,0,0,0,0,1,"DataOne",1,0,0,1
"bbsa",0,0,0,0,0,0,1,"DataOne",1,0,0,1
"bc",0,0,0,0,0,0,1,"DataOne",1,0,0,1
"bd positive",0,0,0,0,0,0,1,"DataOne",1,0,0,1
"be",0,0,0,0,0,0,1,"DataOne",1,0,0,1
"be_ppm_aes_st",0,0,0,0,0,0,1,"DataOne",1,0,0,1
"be_ppm_es_sq",0,0,0,0,0,0,1,"DataOne",1,0,0,1
"bear",0,0,0,0,0,0,1,"DataOne",1,0,0,1
"bedford shale",0,0,0,0,0,0,1,"DataOne",1,0,0,1
"bedforms",0,0,0,0,0,0,1,"DataOne",1,0,0,1
"bedrock",0,0,0,0,0,0,1,"DataOne",1,0,0,1
"bedrock",0,0,0,0,0,0,1,"DataOne",1,0,0,1
"benches",0,0,0,0,0,0,1,"DataOne",1,0,0,1
"benthic",0,0,0,0,0,0,1,"DataOne",1,0,0,1
"bentonite pit",0,0,0,0,0,0,1,"DataOne",1,0,0,1
"beta",0,0,0,0,0,0,1,"DataOne",1,0,0,1
"bhc",0,0,0,0,0,0,1,"DataOne",1,0,0,1
"bi",0,0,0,0,0,0,1,"DataOne",1,0,0,1
"bi_ppm_aes_az_p",0,0,0,0,0,0,1,"DataOne",1,0,0,1
"bi_ppm_es_sq",0,0,0,0,0,0,1,"DataOne",1,0,0,1
"bi_ppm_ms_st",0,0,0,0,0,0,1,"DataOne",1,0,0,1
"big sioux aquifer",0,0,0,0,0,0,1,"DataOne",1,0,0,1
"billion cubic feet gas / km2",0,0,0,0,0,0,1,"DataOne",1,0,0,1
"billion cubic meters",0,0,0,0,0,0,1,"DataOne",1,0,0,1
"bio-surveys, llc",0,0,0,0,0,0,1,"DataOne",1,0,0,1
"biomassdensityunitperabundanceunit",0,0,0,0,0,0,1,"DataOne",1,0,0,1
"biting seal",0,0,0,0,0,0,1,"DataOne",1,0,0,1
"bivalve",0,0,0,0,0,0,1,"DataOne",1,0,0,1
"bivalvia",0,0,0,0,0,0,1,"DataOne",1,0,0,1
"blacknose dace",0,0,0,0,0,0,1,"DataOne",1,0,0,1
"blk",0,0,0,0,0,0,1,"DataOne",1,0,0,1
"blki",0,0,0,0,0,0,1,"DataOne",1,0,0,1
"blm",0,0,0,0,0,0,1,"DataOne",1,0,0,1
"blm las cienegas nca",0,0,0,0,0,0,1,"DataOne",1,0,0,1
"blm san pedro rca",0,0,0,0,0,0,1,"DataOne",1,0,0,1
"block island sound",0,0,0,0,0,0,1,"DataOne",1,0,0,1
"blood",0,0,0,0,0,0,1,"DataOne",1,0,0,1
"blood sample",0,0,0,0,0,0,1,"DataOne",1,0,0,1
"blood/fp",0,0,0,0,0,0,1,"DataOne",1,0,0,1
"blood/lpb",0,0,0,0,0,0,1,"DataOne",1,0,0,1
"blowout",0,0,0,0,0,0,1,"DataOne",1,0,0,1
"bluegill sunfish",0,0,0,0,0,0,1,"DataOne",1,0,0,1
"bluntnose minnow",0,0,0,0,0,0,1,"DataOne",1,0,0,1
"bockman65",0,0,0,0,0,0,1,"DataOne",1,0,0,1
"bocy",0,0,0,0,0,0,1,"DataOne",1,0,0,1
"bone",0,0,0,0,0,0,1,"DataOne",1,0,0,1
"booth",0,0,0,0,0,0,1,"DataOne",1,0,0,1
"boq",0,0,0,0,0,0,1,"DataOne",1,0,0,1
"borrow pit",0,0,0,0,0,0,1,"DataOne",1,0,0,1
"bosminidae",0,0,0,0,0,0,1,"DataOne",1,0,0,1
"both",0,0,0,0,0,0,1,"DataOne",1,0,0,1
"bothner",0,0,0,0,0,0,1,"DataOne",1,0,0,1
"bottom",0,0,0,0,0,0,1,"DataOne",1,0,0,1
"boulder basin",0,0,0,0,0,0,1,"DataOne",1,0,0,1
"br",0,0,0,0,0,0,1,"DataOne",1,0,0,1
"br",0,0,0,0,0,0,1,"DataOne",1,0,0,1
"brachycentridae",0,0,0,0,0,0,1,"DataOne",1,0,0,1
"brachyramphus brevirostris",0,0,0,0,0,0,1,"DataOne",1,0,0,1
"brachyramphus marmoratus",0,0,0,0,0,0,1,"DataOne",1,0,0,1
"brackish to salty",0,0,0,0,0,0,1,"DataOne",1,0,0,1
"braconidae",0,0,0,0,0,0,1,"DataOne",1,0,0,1
"bratton",0,0,0,0,0,0,1,"DataOne",1,0,0,1
"brb",0,0,0,0,0,0,1,"DataOne",1,0,0,1
"breaking into lair",0,0,0,0,0,0,1,"DataOne",1,0,0,1
"breeding",0,0,0,0,0,0,1,"DataOne",1,0,0,1
"bridge",0,0,0,0,0,0,1,"DataOne",1,0,0,1
"brook trout",0,0,0,0,0,0,1,"DataOne",1,0,0,1
"brown trout",0,0,0,0,0,0,1,"DataOne",1,0,0,1
"bsal positive",0,0,0,0,0,0,1,"DataOne",1,0,0,1
"btgo",0,0,0,0,0,0,1,"DataOne",1,0,0,1
"btpd",0,0,0,0,0,0,1,"DataOne",1,0,0,1
"buildingsperkilometer",0,0,0,0,0,0,1,"DataOne",1,0,0,1
"buldir island",0,0,0,0,0,0,1,"DataOne",1,0,0,1
"bulk organic, picked free of roots",0,0,0,0,0,0,1,"DataOne",1,0,0,1
"bulk zooplankton",0,0,0,0,0,0,1,"DataOne",1,0,0,1
"bull trout",0,0,0,0,0,0,1,"DataOne",1,0,0,1
"bull trout (bt) 11",0,0,0,0,0,0,1,"DataOne",1,0,0,1
"bull trout (bt) 12",0,0,0,0,0,0,1,"DataOne",1,0,0,1
"bull trout (bt) 23",0,0,0,0,0,0,1,"DataOne",1,0,0,1
"bull trout (bt) 3",0,0,0,0,0,0,1,"DataOne",1,0,0,1
"bull trout (bt) 4",0,0,0,0,0,0,1,"DataOne",1,0,0,1
"bull trout (bt) 5",0,0,0,0,0,0,1,"DataOne",1,0,0,1
"bull trout (bt) 8",0,0,0,0,0,0,1,"DataOne",1,0,0,1
"bull trout (bt) 9",0,0,0,0,0,0,1,"DataOne",1,0,0,1
"buried utility",0,0,0,0,0,0,1,"DataOne",1,0,0,1
"burket shale member",0,0,0,0,0,0,1,"DataOne",1,0,0,1
"burp",0,0,0,0,0,0,1,"DataOne",1,0,0,1
"bushy park res. above foster crk, goose creek,sc",0,0,0,0,0,0,1,"DataOne",1,0,0,1
"butman",0,0,0,0,0,0,1,"DataOne",1,0,0,1
"buttonbush",0,0,0,0,0,0,1,"DataOne",1,0,0,1
"buynevich2001",0,0,0,0,0,0,1,"DataOne",1,0,0,1
"bv",0,0,0,0,0,0,1,"DataOne",1,0,0,1
"bv01",0,0,0,0,0,0,1,"DataOne",1,0,0,1
"bv02",0,0,0,0,0,0,1,"DataOne",1,0,0,1
"bv03",0,0,0,0,0,0,1,"DataOne",1,0,0,1
"bv04",0,0,0,0,0,0,1,"DataOne",1,0,0,1
"bv05",0,0,0,0,0,0,1,"DataOne",1,0,0,1
"bv06",0,0,0,0,0,0,1,"DataOne",1,0,0,1
"bv07",0,0,0,0,0,0,1,"DataOne",1,0,0,1
"bwm55",0,0,0,0,0,0,1,"DataOne",1,0,0,1
"bwm98",0,0,0,0,0,0,1,"DataOne",1,0,0,1
"c for closed and o for open (ongoing)",0,0,0,0,0,0,1,"DataOne",1,0,0,1
"c1",0,0,0,0,0,0,1,"DataOne",1,0,0,1
"c2",0,0,0,0,0,0,1,"DataOne",1,0,0,1
"c3",0,0,0,0,0,0,1,"DataOne",1,0,0,1
"c4",0,0,0,0,0,0,1,"DataOne",1,0,0,1
"c7",0,0,0,0,0,0,1,"DataOne",1,0,0,1
"ca",0,0,0,0,0,0,1,"DataOne",1,0,0,1
"ca_pct_aes_st",0,0,0,0,0,0,1,"DataOne",1,0,0,1
"ca_pct_es_sq",0,0,0,0,0,0,1,"DataOne",1,0,0,1
"ca_pct_na_lc",0,0,0,0,0,0,1,"DataOne",1,0,0,1
"ca_pct_wdx_fuse",0,0,0,0,0,0,1,"DataOne",1,0,0,1
"cable",0,0,0,0,0,0,1,"DataOne",1,0,0,1
"calendar day",0,0,0,0,0,0,1,"DataOne",1,0,0,1
"caliche pit",0,0,0,0,0,0,1,"DataOne",1,0,0,1
"california",0,0,0,0,0,0,1,"DataOne",1,0,0,1
"california red-legged frog",0,0,0,0,0,0,1,"DataOne",1,0,0,1
"calle cerrado/yfp",0,0,0,0,0,0,1,"DataOne",1,0,0,1
"calm",0,0,0,0,0,0,1,"DataOne",1,0,0,1
"cambrian",0,0,0,0,0,0,1,"DataOne",1,0,0,1
"camp-lu-15",0,0,0,0,0,0,1,"DataOne",1,0,0,1
"campostoma anomalum",0,0,0,0,0,0,1,"DataOne",1,0,0,1
"can",0,0,0,0,0,0,1,"DataOne",1,0,0,1
"canada",0,0,0,0,0,0,1,"DataOne",1,0,0,1
"cand98022",0,0,0,0,0,0,1,"DataOne",1,0,0,1
"canyon",0,0,0,0,0,0,1,"DataOne",1,0,0,1
"canyons south of georges bank",0,0,0,0,0,0,1,"DataOne",1,0,0,1
"cao",0,0,0,0,0,0,1,"DataOne",1,0,0,1
"cao_pct_wdx_fuse",0,0,0,0,0,0,1,"DataOne",1,0,0,1
"caov2",0,0,0,0,0,0,1,"DataOne",1,0,0,1
"cape cod mulitbeam",0,0,0,0,0,0,1,"DataOne",1,0,0,1
"cape romain shoal complex",0,0,0,0,0,0,1,"DataOne",1,0,0,1
"capelin",0,0,0,0,0,0,1,"DataOne",1,0,0,1
"carabidae",0,0,0,0,0,0,1,"DataOne",1,0,0,1
"carcass",0,0,0,0,0,0,1,"DataOne",1,0,0,1
"carex",0,0,0,0,0,0,1,"DataOne",1,0,0,1
"caribbean",0,0,0,0,0,0,1,"DataOne",1,0,0,1
"caribbean hazards",0,0,0,0,0,0,1,"DataOne",1,0,0,1
"carnivores",0,0,0,0,0,0,1,"DataOne",1,0,0,1
"carrying carcass",0,0,0,0,0,0,1,"DataOne",1,0,0,1
"casn",0,0,0,0,0,0,1,"DataOne",1,0,0,1
"cass",0,0,0,0,0,0,1,"DataOne",1,0,0,1
"catches seal",0,0,0,0,0,0,1,"DataOne",1,0,0,1
"catostomus commersonii",0,0,0,0,0,0,1,"DataOne",1,0,0,1
"cb",0,0,0,0,0,0,1,"DataOne",1,0,0,1
"cb_chn",0,0,0,0,0,0,1,"DataOne",1,0,0,1
"cb_irc",0,0,0,0,0,0,1,"DataOne",1,0,0,1
"cb_tc",0,0,0,0,0,0,1,"DataOne",1,0,0,1
"cb_tt",0,0,0,0,0,0,1,"DataOne",1,0,0,1
"ccsm3-5 hydro",0,0,0,0,0,0,1,"DataOne",1,0,0,1
"ccsm3/wrf hydro",0,0,0,0,0,0,1,"DataOne",1,0,0,1
"ccsm3/wrf mc1",0,0,0,0,0,0,1,"DataOne",1,0,0,1
"cd",0,0,0,0,0,0,1,"DataOne",1,0,0,1
"cd_ppm_aes_az_p",0,0,0,0,0,0,1,"DataOne",1,0,0,1
"cd_ppm_es_sq",0,0,0,0,0,0,1,"DataOne",1,0,0,1
"cd_ppm_ms_st",0,0,0,0,0,0,1,"DataOne",1,0,0,1
"ce",0,0,0,0,0,0,1,"DataOne",1,0,0,1
"ce-qpc-02",0,0,0,0,0,0,1,"DataOne",1,0,0,1
"ce_ppm_edx",0,0,0,0,0,0,1,"DataOne",1,0,0,1
"ce_ppm_ms_st",0,0,0,0,0,0,1,"DataOne",1,0,0,1
"ce_ppm_ms_st_ree",0,0,0,0,0,0,1,"DataOne",1,0,0,1
"ce_ppm_na_lc",0,0,0,0,0,0,1,"DataOne",1,0,0,1
"ce_ppm_na_sc",0,0,0,0,0,0,1,"DataOne",1,0,0,1
"cedar",0,0,0,0,0,0,1,"DataOne",1,0,0,1
"cells_per_milliter",0,0,0,0,0,0,1,"DataOne",1,0,0,1
"centimeter per centimeter",0,0,0,0,0,0,1,"DataOne",1,0,0,1
"centimeters?",0,0,0,0,0,0,1,"DataOne",1,0,0,1
"centimetersquare",0,0,0,0,0,0,1,"DataOne",1,0,0,1
"central stoneroller",0,0,0,0,0,0,1,"DataOne",1,0,0,1
"ceratopogonidae",0,0,0,0,0,0,1,"DataOne",1,0,0,1
"cestoda",0,0,0,0,0,0,1,"DataOne",1,0,0,1
"cfs",0,0,0,0,0,0,1,"DataOne",1,0,0,1
"chambersburg limestone",0,0,0,0,0,0,1,"DataOne",1,0,0,1
"channel",0,0,0,0,0,0,1,"DataOne",1,0,0,1
"channel catfish",0,0,0,0,0,0,1,"DataOne",1,0,0,1
"chaoboridae",0,0,0,0,0,0,1,"DataOne",1,0,0,1
"chapman",0,0,0,0,0,0,1,"DataOne",1,0,0,1
"charadriiformes",0,0,0,0,0,0,1,"DataOne",1,0,0,1
"chatham island",0,0,0,0,0,0,1,"DataOne",1,0,0,1
"chattanooga shale",0,0,0,0,0,0,1,"DataOne",1,0,0,1
"cheese",0,0,0,0,0,0,1,"DataOne",1,0,0,1
"cheese and worms",0,0,0,0,0,0,1,"DataOne",1,0,0,1
"chefornak, y-k delta",0,0,0,0,0,0,1,"DataOne",1,0,0,1
"chemung formation",0,0,0,0,0,0,1,"DataOne",1,0,0,1
"chenega",0,0,0,0,0,0,1,"DataOne",1,0,0,1
"cherry run member",0,0,0,0,0,0,1,"DataOne",1,0,0,1
"cherry valley limestone member",0,0,0,0,0,0,1,"DataOne",1,0,0,1
"cheval island",0,0,0,0,0,0,1,"DataOne",1,0,0,1
"chevy ford",0,0,0,0,0,0,1,"DataOne",1,0,0,1
"chinese tallow",0,0,0,0,0,0,1,"DataOne",1,0,0,1
"chinook",0,0,0,0,0,0,1,"DataOne",1,0,0,1
"chipp north",0,0,0,0,0,0,1,"DataOne",1,0,0,1
"chippewa",0,0,0,0,0,0,1,"DataOne",1,0,0,1
"chironomidae",0,0,0,0,0,0,1,"DataOne",1,0,0,1
"christopher andrew",0,0,0,0,0,0,1,"DataOne",1,0,0,1
"chum",0,0,0,0,0,0,1,"DataOne",1,0,0,1
"chydoridae",0,0,0,0,0,0,1,"DataOne",1,0,0,1
"ci, cl, or dl",0,0,0,0,0,0,1,"DataOne",1,0,0,1
"ciconiiformes",0,0,0,0,0,0,1,"DataOne",1,0,0,1
"cinder pit",0,0,0,0,0,0,1,"DataOne",1,0,0,1
"cisco",0,0,0,0,0,0,1,"DataOne",1,0,0,1
"city of portland- bes",0,0,0,0,0,0,1,"DataOne",1,0,0,1
"ck sht",0,0,0,0,0,0,1,"DataOne",1,0,0,1
"cl",0,0,0,0,0,0,1,"DataOne",1,0,0,1
"cl-st/sd",0,0,0,0,0,0,1,"DataOne",1,0,0,1
"cl_pct_ise_fuse",0,0,0,0,0,0,1,"DataOne",1,0,0,1
"cladocera",0,0,0,0,0,0,1,"DataOne",1,0,0,1
"clallam",0,0,0,0,0,0,1,"DataOne",1,0,0,1
"class aves",0,0,0,0,0,0,1,"DataOne",1,0,0,1
"clay",0,0,0,0,0,0,1,"DataOne",1,0,0,1
"clay-silt",0,0,0,0,0,0,1,"DataOne",1,0,0,1
"clay pit",0,0,0,0,0,0,1,"DataOne",1,0,0,1
"clayey sand",0,0,0,0,0,0,1,"DataOne",1,0,0,1
"clayey silt",0,0,0,0,0,0,1,"DataOne",1,0,0,1
"clayey silt",0,0,0,0,0,0,1,"DataOne",1,0,0,1
"clean water services",0,0,0,0,0,0,1,"DataOne",1,0,0,1
"cleveland member",0,0,0,0,0,0,1,"DataOne",1,0,0,1
"cliff retreat rate (m/yr), x.xx m slr",0,0,0,0,0,0,1,"DataOne",1,0,0,1
"closed_canopy",0,0,0,0,0,0,1,"DataOne",1,0,0,1
"clupea pallasii",0,0,0,0,0,0,1,"DataOne",1,0,0,1
"cm",0,0,0,0,0,0,1,"DataOne",1,0,0,1
"cm nadv88",0,0,0,0,0,0,1,"DataOne",1,0,0,1
"cm per s",0,0,0,0,0,0,1,"DataOne",1,0,0,1
"cm per second^(1/2)",0,0,0,0,0,0,1,"DataOne",1,0,0,1
"cm_acid",0,0,0,0,0,0,1,"DataOne",1,0,0,1
"cm_acid_p",0,0,0,0,0,0,1,"DataOne",1,0,0,1
"cm_ar",0,0,0,0,0,0,1,"DataOne",1,0,0,1
"cm_fuse",0,0,0,0,0,0,1,"DataOne",1,0,0,1
"cm_fuse_p",0,0,0,0,0,0,1,"DataOne",1,0,0,1
"cm_hcl",0,0,0,0,0,0,1,"DataOne",1,0,0,1
"cm_hf",0,0,0,0,0,0,1,"DataOne",1,0,0,1
"cm_hfs",0,0,0,0,0,0,1,"DataOne",1,0,0,1
"cm_hno3_p",0,0,0,0,0,0,1,"DataOne",1,0,0,1
"cm_pc_p",0,0,0,0,0,0,1,"DataOne",1,0,0,1
"cm_sddc",0,0,0,0,0,0,1,"DataOne",1,0,0,1
"cm_st",0,0,0,0,0,0,1,"DataOne",1,0,0,1
"cm_st_p",0,0,0,0,0,0,1,"DataOne",1,0,0,1
"cm1",0,0,0,0,0,0,1,"DataOne",1,0,0,1
"cm2 g-1",0,0,0,0,0,0,1,"DataOne",1,0,0,1
"cmolc/dm3",0,0,0,0,0,0,1,"DataOne",1,0,0,1
"cn",0,0,0,0,0,0,1,"DataOne",1,0,0,1
"cn/lt",0,0,0,0,0,0,1,"DataOne",1,0,0,1
"cnsn",0,0,0,0,0,0,1,"DataOne",1,0,0,1
"co",0,0,0,0,0,0,1,"DataOne",1,0,0,1
"co_ppm_aes_fuse",0,0,0,0,0,0,1,"DataOne",1,0,0,1
"co_ppm_es_sq",0,0,0,0,0,0,1,"DataOne",1,0,0,1
"co_ppm_ms_st",0,0,0,0,0,0,1,"DataOne",1,0,0,1
"co_ppm_na_lc",0,0,0,0,0,0,1,"DataOne",1,0,0,1
"co_ppm_na_sc",0,0,0,0,0,0,1,"DataOne",1,0,0,1
"co2",0,0,0,0,0,0,1,"DataOne",1,0,0,1
"co2_pct_tt_hcl",0,0,0,0,0,0,1,"DataOne",1,0,0,1
"coal mine",0,0,0,0,0,0,1,"DataOne",1,0,0,1
"coarse-grained substrate",0,0,0,0,0,0,1,"DataOne",1,0,0,1
"coarse gravel",0,0,0,0,0,0,1,"DataOne",1,0,0,1
"coarse sand",0,0,0,0,0,0,1,"DataOne",1,0,0,1
"coarse sand and gravel",0,0,0,0,0,0,1,"DataOne",1,0,0,1
"coarser than sand",0,0,0,0,0,0,1,"DataOne",1,0,0,1
"coastal carolina univ.",0,0,0,0,0,0,1,"DataOne",1,0,0,1
"coastal embayment",0,0,0,0,0,0,1,"DataOne",1,0,0,1
"coastal plain",0,0,0,0,0,0,1,"DataOne",1,0,0,1
"cobbles",0,0,0,0,0,0,1,"DataOne",1,0,0,1
"coho",0,0,0,0,0,0,1,"DataOne",1,0,0,1
"coking bituminous coal",0,0,0,0,0,0,1,"DataOne",1,0,0,1
"cold brook (nh)",0,0,0,0,0,0,1,"DataOne",1,0,0,1
"coleoptera",0,0,0,0,0,0,1,"DataOne",1,0,0,1
"collar code",0,0,0,0,0,0,1,"DataOne",1,0,0,1
"collembola",0,0,0,0,0,0,1,"DataOne",1,0,0,1
"colman",0,0,0,0,0,0,1,"DataOne",1,0,0,1
"colonies per 100 milliliters",0,0,0,0,0,0,1,"DataOne",1,0,0,1
"colorado",0,0,0,0,0,0,1,"DataOne",1,0,0,1
"colus halli",0,0,0,0,0,0,1,"DataOne",1,0,0,1
"colv",0,0,0,0,0,0,1,"DataOne",1,0,0,1
"colville river",0,0,0,0,0,0,1,"DataOne",1,0,0,1
"comm",0,0,0,0,0,0,1,"DataOne",1,0,0,1
"commander islands",0,0,0,0,0,0,1,"DataOne",1,0,0,1
"common shiner",0,0,0,0,0,0,1,"DataOne",1,0,0,1
"conn03014",0,0,0,0,0,0,1,"DataOne",1,0,0,1
"connecticut",0,0,0,0,0,0,1,"DataOne",1,0,0,1
"conococheague limestone",0,0,0,0,0,0,1,"DataOne",1,0,0,1
"conte anadromous fish laboratory (ma)",0,0,0,0,0,0,1,"DataOne",1,0,0,1
"continuous",0,0,0,0,0,0,1,"DataOne",1,0,0,1
"control (no fish)",0,0,0,0,0,0,1,"DataOne",1,0,0,1
"cooper river at inlet to back river",0,0,0,0,0,0,1,"DataOne",1,0,0,1
"copepod",0,0,0,0,0,0,1,"DataOne",1,0,0,1
"copepoda",0,0,0,0,0,0,1,"DataOne",1,0,0,1
"copies/second",0,0,0,0,0,0,1,"DataOne",1,0,0,1
"coraciiformes",0,0,0,0,0,0,1,"DataOne",1,0,0,1
"core",0,0,0,0,0,0,1,"DataOne",1,0,0,1
"core/cuttings",0,0,0,0,0,0,1,"DataOne",1,0,0,1
"cores",0,0,0,0,0,0,1,"DataOne",1,0,0,1
"coronella austriaca",0,0,0,0,0,0,1,"DataOne",1,0,0,1
"corriganville limestone",0,0,0,0,0,0,1,"DataOne",1,0,0,1
"cottus bairdii",0,0,0,0,0,0,1,"DataOne",1,0,0,1
"cottus cognatus",0,0,0,0,0,0,1,"DataOne",1,0,0,1
"coulomb",0,0,0,0,0,0,1,"DataOne",1,0,0,1
"counts",0,0,0,0,0,0,1,"DataOne",1,0,0,1
"counts in histogram bins",0,0,0,0,0,0,1,"DataOne",1,0,0,1
"county: riverside",0,0,0,0,0,0,1,"DataOne",1,0,0,1
"cp",0,0,0,0,0,0,1,"DataOne",1,0,0,1
"cr",0,0,0,0,0,0,1,"DataOne",1,0,0,1
"cr",0,0,0,0,0,0,1,"DataOne",1,0,0,1
"cr_ppm_aes_st",0,0,0,0,0,0,1,"DataOne",1,0,0,1
"cr_ppm_edx",0,0,0,0,0,0,1,"DataOne",1,0,0,1
"cr_ppm_es_sq",0,0,0,0,0,0,1,"DataOne",1,0,0,1
"cr_ppm_na_lc",0,0,0,0,0,0,1,"DataOne",1,0,0,1
"cr_ppm_na_sc",0,0,0,0,0,0,1,"DataOne",1,0,0,1
"cr_ppm_wdx_fuse",0,0,0,0,0,0,1,"DataOne",1,0,0,1
"craib",0,0,0,0,0,0,1,"DataOne",1,0,0,1
"crata",0,0,0,0,0,0,1,"DataOne",1,0,0,1
"crawling through ice cavern",0,0,0,0,0,0,1,"DataOne",1,0,0,1
"crc",0,0,0,0,0,0,1,"DataOne",1,0,0,1
"creek",0,0,0,0,0,0,1,"DataOne",1,0,0,1
"cretaceous - rocks of the pee dee formation",0,0,0,0,0,0,1,"DataOne",1,0,0,1
"crms id",0,0,0,0,0,0,1,"DataOne",1,0,0,1
"crusius",0,0,0,0,0,0,1,"DataOne",1,0,0,1
"crustacea",0,0,0,0,0,0,1,"DataOne",1,0,0,1
"cryptic",0,0,0,0,0,0,1,"DataOne",1,0,0,1
"cs",0,0,0,0,0,0,1,"DataOne",1,0,0,1
"cs_ppm_ms_ar_p",0,0,0,0,0,0,1,"DataOne",1,0,0,1
"cs_ppm_ms_st",0,0,0,0,0,0,1,"DataOne",1,0,0,1
"cs_ppm_na_lc",0,0,0,0,0,0,1,"DataOne",1,0,0,1
"cs_ppm_na_sc",0,0,0,0,0,0,1,"DataOne",1,0,0,1
"csg",0,0,0,0,0,0,1,"DataOne",1,0,0,1
"csiro mc1",0,0,0,0,0,0,1,"DataOne",1,0,0,1
"csm bird route1",0,0,0,0,0,0,1,"DataOne",1,0,0,1
"ctab",0,0,0,0,0,0,1,"DataOne",1,0,0,1
"ctr",0,0,0,0,0,0,1,"DataOne",1,0,0,1
"cu",0,0,0,0,0,0,1,"DataOne",1,0,0,1
"cu_ppm_aes_az_p",0,0,0,0,0,0,1,"DataOne",1,0,0,1
"cu_ppm_aes_st",0,0,0,0,0,0,1,"DataOne",1,0,0,1
"cu_ppm_edx",0,0,0,0,0,0,1,"DataOne",1,0,0,1
"cu_ppm_es_sq",0,0,0,0,0,0,1,"DataOne",1,0,0,1
"cubic micrometer per milliliter",0,0,0,0,0,0,1,"DataOne",1,0,0,1
"cubiccentimeter",0,0,0,0,0,0,1,"DataOne",1,0,0,1
"current era.",0,0,0,0,0,0,1,"DataOne",1,0,0,1
"cutlip minnow",0,0,0,0,0,0,1,"DataOne",1,0,0,1
"cuttings",0,0,0,0,0,0,1,"DataOne",1,0,0,1
"cv240",0,0,0,0,0,0,1,"DataOne",1,0,0,1
"cv30",0,0,0,0,0,0,1,"DataOne",1,0,0,1
"cw-7 back r below foster ck at hwy5(8-503)",0,0,0,0,0,0,1,"DataOne",1,0,0,1
"cwish-01",0,0,0,0,0,0,1,"DataOne",1,0,0,1
"cws-1",0,0,0,0,0,0,1,"DataOne",1,0,0,1
"cws-2",0,0,0,0,0,0,1,"DataOne",1,0,0,1
"cws-3",0,0,0,0,0,0,1,"DataOne",1,0,0,1
"cws-3 on bushy park res,goose creek sc",0,0,0,0,0,0,1,"DataOne",1,0,0,1
"cws-4",0,0,0,0,0,0,1,"DataOne",1,0,0,1
"cws-4 on bushy park res, goose creek sc",0,0,0,0,0,0,1,"DataOne",1,0,0,1
"cws-5",0,0,0,0,0,0,1,"DataOne",1,0,0,1
"cws-6",0,0,0,0,0,0,1,"DataOne",1,0,0,1
"cws-6 @ foster creek, goose creek sc",0,0,0,0,0,0,1,"DataOne",1,0,0,1
"cws-7",0,0,0,0,0,0,1,"DataOne",1,0,0,1
"cycle threshold",0,0,0,0,0,0,1,"DataOne",1,0,0,1
"cycle threshold (ct) value",0,0,0,0,0,0,1,"DataOne",1,0,0,1
"cycle threshold ct",0,0,0,0,0,0,1,"DataOne",1,0,0,1
"cycle threshold values",0,0,0,0,0,0,1,"DataOne",1,0,0,1
"cyclopoida",0,0,0,0,0,0,1,"DataOne",1,0,0,1
"cyprinella spiloptera",0,0,0,0,0,0,1,"DataOne",1,0,0,1
"cz",0,0,0,0,0,0,1,"DataOne",1,0,0,1
"czech republic branisov",0,0,0,0,0,0,1,"DataOne",1,0,0,1
"d14c =(fm meas*exp(0.00012097*(1950-year))-1)*1000, per mil (0/00)",0,0,0,0,0,0,1,"DataOne",1,0,0,1
"d14c=(dfm*exp(0.00012097*(1950-year))-1)*1000, per mil (0/00)",0,0,0,0,0,0,1,"DataOne",1,0,0,1
"dahoon",0,0,0,0,0,0,1,"DataOne",1,0,0,1
"daphniidae",0,0,0,0,0,0,1,"DataOne",1,0,0,1
"dash",0,0,0,0,0,0,1,"DataOne",1,0,0,1
"dashed",0,0,0,0,0,0,1,"DataOne",1,0,0,1
"data release",0,0,0,0,0,0,1,"DataOne",1,0,0,1
"date (month/day/year)",0,0,0,0,0,0,1,"DataOne",1,0,0,1
"date (year)",0,0,0,0,0,0,1,"DataOne",1,0,0,1
"date defined as mm/dd/yyyy",0,0,0,0,0,0,1,"DataOne",1,0,0,1
"date in mm/dd/yy",0,0,0,0,0,0,1,"DataOne",1,0,0,1
"date in mm/dd/yyyy",0,0,0,0,0,0,1,"DataOne",1,0,0,1
"date, defined as yyyymmdd",0,0,0,0,0,0,1,"DataOne",1,0,0,1
"date, hours, minutes",0,0,0,0,0,0,1,"DataOne",1,0,0,1
"date, in yyyymmdd",0,0,0,0,0,0,1,"DataOne",1,0,0,1
"date/time 8/3/2016 11:32am",0,0,0,0,0,0,1,"DataOne",1,0,0,1
"date/time 8/3/2016 3:05pm",0,0,0,0,0,0,1,"DataOne",1,0,0,1
"date/time 8/4/2016 10:10am",0,0,0,0,0,0,1,"DataOne",1,0,0,1
"date/time 8/5/2016 10:34am",0,0,0,0,0,0,1,"DataOne",1,0,0,1
"date/time 8/5/2016 2:10pm",0,0,0,0,0,0,1,"DataOne",1,0,0,1
"dates",0,0,0,0,0,0,1,"DataOne",1,0,0,1
"david starr jordan",0,0,0,0,0,0,1,"DataOne",1,0,0,1
"day number within current year",0,0,0,0,0,0,1,"DataOne",1,0,0,1
"day of the week.",0,0,0,0,0,0,1,"DataOne",1,0,0,1
"day of visit",0,0,0,0,0,0,1,"DataOne",1,0,0,1
"dbdg",0,0,0,0,0,0,1,"DataOne",1,0,0,1
"dcp",0,0,0,0,0,0,1,"DataOne",1,0,0,1
"dcp_fuse",0,0,0,0,0,0,1,"DataOne",1,0,0,1
"dcp_hf",0,0,0,0,0,0,1,"DataOne",1,0,0,1
"debris flow",0,0,0,0,0,0,1,"DataOne",1,0,0,1
"dec",0,0,0,0,0,0,1,"DataOne",1,0,0,1
"decimal degrees west",0,0,0,0,0,0,1,"DataOne",1,0,0,1
"deer mountain",0,0,0,0,0,0,1,"DataOne",1,0,0,1
"deer valley limestone member",0,0,0,0,0,0,1,"DataOne",1,0,0,1
"degree",0,0,0,0,0,0,1,"DataOne",1,0,0,1
"degree celsius",0,0,0,0,0,0,1,"DataOne",1,0,0,1
"degrees (000-359) with 'az' prefix",0,0,0,0,0,0,1,"DataOne",1,0,0,1
"degrees celcius",0,0,0,0,0,0,1,"DataOne",1,0,0,1
"degrees celsius",0,0,0,0,0,0,1,"DataOne",1,0,0,1
"degrees celsius (â°c)",0,0,0,0,0,0,1,"DataOne",1,0,0,1
"degrees celsius (c)",0,0,0,0,0,0,1,"DataOne",1,0,0,1
"degrees centigrade",0,0,0,0,0,0,1,"DataOne",1,0,0,1
"degrees centigrade",0,0,0,0,0,0,1,"DataOne",1,0,0,1
"degrees centigrade multiplied by 100",0,0,0,0,0,0,1,"DataOne",1,0,0,1
"degrees east",0,0,0,0,0,0,1,"DataOne",1,0,0,1
"degrees west",0,0,0,0,0,0,1,"DataOne",1,0,0,1
"degrees, clockwise from north",0,0,0,0,0,0,1,"DataOne",1,0,0,1
"delaware ii",0,0,0,0,0,0,1,"DataOne",1,0,0,1
"delaware river (pa/ny), neversink river (ny)",0,0,0,0,0,0,1,"DataOne",1,0,0,1
"delaware river mainstem (pa/ny)",0,0,0,0,0,0,1,"DataOne",1,0,0,1
"delta r= 0 +/-",0,0,0,0,0,0,1,"DataOne",1,0,0,1
"delta/gas",0,0,0,0,0,0,1,"DataOne",1,0,0,1
"dempsey",0,0,0,0,0,0,1,"DataOne",1,0,0,1
"denny",0,0,0,0,0,0,1,"DataOne",1,0,0,1
"density of low-tall shrubs",0,0,0,0,0,0,1,"DataOne",1,0,0,1
"dep_01",0,0,0,0,0,0,1,"DataOne",1,0,0,1
"dep_02",0,0,0,0,0,0,1,"DataOne",1,0,0,1
"dep_03",0,0,0,0,0,0,1,"DataOne",1,0,0,1
"dep_04",0,0,0,0,0,0,1,"DataOne",1,0,0,1
"dep_05",0,0,0,0,0,0,1,"DataOne",1,0,0,1
"dep_06",0,0,0,0,0,0,1,"DataOne",1,0,0,1
"dep_07",0,0,0,0,0,0,1,"DataOne",1,0,0,1
"dep_08",0,0,0,0,0,0,1,"DataOne",1,0,0,1
"dep_09",0,0,0,0,0,0,1,"DataOne",1,0,0,1
"dep_10",0,0,0,0,0,0,1,"DataOne",1,0,0,1
"dep_undiff",0,0,0,0,0,0,1,"DataOne",1,0,0,1
"deposition",0,0,0,0,0,0,1,"DataOne",1,0,0,1
"depression",0,0,0,0,0,0,1,"DataOne",1,0,0,1
"depressions",0,0,0,0,0,0,1,"DataOne",1,0,0,1
"depth in meters - 2 is surface sample",0,0,0,0,0,0,1,"DataOne",1,0,0,1
"depth, in meters",0,0,0,0,0,0,1,"DataOne",1,0,0,1
"deschutes",0,0,0,0,0,0,1,"DataOne",1,0,0,1
"detritivore",0,0,0,0,0,0,1,"DataOne",1,0,0,1
"developed, high-intensity",0,0,0,0,0,0,1,"DataOne",1,0,0,1
"developed, low-intensity",0,0,0,0,0,0,1,"DataOne",1,0,0,1
"developed, medium-intensity",0,0,0,0,0,0,1,"DataOne",1,0,0,1
"devonian",0,0,0,0,0,0,1,"DataOne",1,0,0,1
"dewatto",0,0,0,0,0,0,1,"DataOne",1,0,0,1
"dgbl",0,0,0,0,0,0,1,"DataOne",1,0,0,1
"diabase",0,0,0,0,0,0,1,"DataOne",1,0,0,1
"dian96025",0,0,0,0,0,0,1,"DataOne",1,0,0,1
"diane g",0,0,0,0,0,0,1,"DataOne",1,0,0,1
"digging",0,0,0,0,0,0,1,"DataOne",1,0,0,1
"diggings",0,0,0,0,0,0,1,"DataOne",1,0,0,1
"diptera",0,0,0,0,0,0,1,"DataOne",1,0,0,1
"direct",0,0,0,0,0,0,1,"DataOne",1,0,0,1
"disintegrations per minute per gram (dpm/g)",0,0,0,0,0,0,1,"DataOne",1,0,0,1
"disturbed",0,0,0,0,0,0,1,"DataOne",1,0,0,1
"disturbed surface",0,0,0,0,0,0,1,"DataOne",1,0,0,1
"disturbed surface - pit",0,0,0,0,0,0,1,"DataOne",1,0,0,1
"ditch",0,0,0,0,0,0,1,"DataOne",1,0,0,1
"diver operated push core",0,0,0,0,0,0,1,"DataOne",1,0,0,1
"dixidae",0,0,0,0,0,0,1,"DataOne",1,0,0,1
"dlwr93006",0,0,0,0,0,0,1,"DataOne",1,0,0,1
"dlwr93030",0,0,0,0,0,0,1,"DataOne",1,0,0,1
"dlwr99011",0,0,0,0,0,0,1,"DataOne",1,0,0,1
"dm",0,0,0,0,0,0,1,"DataOne",1,0,0,1
"dm-26",0,0,0,0,0,0,1,"DataOne",1,0,0,1
"dmo",0,0,0,0,0,0,1,"DataOne",1,0,0,1
"dna copies",0,0,0,0,0,0,1,"DataOne",1,0,0,1
"dna copies per reaction",0,0,0,0,0,0,1,"DataOne",1,0,0,1
"do",0,0,0,0,0,0,1,"DataOne",1,0,0,1
"dolomitic mudrock",0,0,0,0,0,0,1,"DataOne",1,0,0,1
"dolostone",0,0,0,0,0,0,1,"DataOne",1,0,0,1
"dop",0,0,0,0,0,0,1,"DataOne",1,0,0,1
"double",0,0,0,0,0,0,1,"DataOne",1,0,0,1
"dpp",0,0,0,0,0,0,1,"DataOne",1,0,0,1
"dr4",0,0,0,0,0,0,1,"DataOne",1,0,0,1
"dr5",0,0,0,0,0,0,1,"DataOne",1,0,0,1
"dr6",0,0,0,0,0,0,1,"DataOne",1,0,0,1
"dr7",0,0,0,0,0,0,1,"DataOne",1,0,0,1
"dredge",0,0,0,0,0,0,1,"DataOne",1,0,0,1
"dredge events",0,0,0,0,0,0,1,"DataOne",1,0,0,1
"dredge spoils",0,0,0,0,0,0,1,"DataOne",1,0,0,1
"dredge spoils",0,0,0,0,0,0,1,"DataOne",1,0,0,1
"dredge/oyster",0,0,0,0,0,0,1,"DataOne",1,0,0,1
"dredged channel",0,0,0,0,0,0,1,"DataOne",1,0,0,1
"drill",0,0,0,0,0,0,1,"DataOne",1,0,0,1
"drill rig",0,0,0,0,0,0,1,"DataOne",1,0,0,1
"drive-point piezometer",0,0,0,0,0,0,1,"DataOne",1,0,0,1
"drumlin",0,0,0,0,0,0,1,"DataOne",1,0,0,1
"drumlins",0,0,0,0,0,0,1,"DataOne",1,0,0,1
"ds",0,0,0,0,0,0,1,"DataOne",1,0,0,1
"duckabush",0,0,0,0,0,0,1,"DataOne",1,0,0,1
"dungeness",0,0,0,0,0,0,1,"DataOne",1,0,0,1
"dunl",0,0,0,0,0,0,1,"DataOne",1,0,0,1
"duplicate",0,0,0,0,0,0,1,"DataOne",1,0,0,1
"durham canal at bridge to cypress garden, sc",0,0,0,0,0,0,1,"DataOne",1,0,0,1
"dy",0,0,0,0,0,0,1,"DataOne",1,0,0,1
"dy_ppm_ms_st",0,0,0,0,0,0,1,"DataOne",1,0,0,1
"dy_ppm_ms_st_ree",0,0,0,0,0,0,1,"DataOne",1,0,0,1
"dytiscidae",0,0,0,0,0,0,1,"DataOne",1,0,0,1
"e (east), c (central), and w (west)",0,0,0,0,0,0,1,"DataOne",1,0,0,1
"earb",0,0,0,0,0,0,1,"DataOne",1,0,0,1
"earliest possible",0,0,0,0,0,0,1,"DataOne",1,0,0,1
"early",0,0,0,0,0,0,1,"DataOne",1,0,0,1
"eastern baccharis",0,0,0,0,0,0,1,"DataOne",1,0,0,1
"eastern north american wet meadow group",0,0,0,0,0,0,1,"DataOne",1,0,0,1
"eastward",0,0,0,0,0,0,1,"DataOne",1,0,0,1
"eating",0,0,0,0,0,0,1,"DataOne",1,0,0,1
"eating snow",0,0,0,0,0,0,1,"DataOne",1,0,0,1
"eau claire formation",0,0,0,0,0,0,1,"DataOne",1,0,0,1
"ebb",0,0,0,0,0,0,1,"DataOne",1,0,0,1
"ec",0,0,0,0,0,0,1,"DataOne",1,0,0,1
"edem",0,0,0,0,0,0,1,"DataOne",1,0,0,1
"edgartown harbor",0,0,0,0,0,0,1,"DataOne",1,0,0,1
"edge",0,0,0,0,0,0,1,"DataOne",1,0,0,1
"edinburg formation",0,0,0,0,0,0,1,"DataOne",1,0,0,1
"edmonton quebec",0,0,0,0,0,0,1,"DataOne",1,0,0,1
"edwin link",0,0,0,0,0,0,1,"DataOne",1,0,0,1
"eek, y-k delta",0,0,0,0,0,0,1,"DataOne",1,0,0,1
"eggs per meter square",0,0,0,0,0,0,1,"DataOne",1,0,0,1
"eggshell membrane",0,0,0,0,0,0,1,"DataOne",1,0,0,1
"ek",0,0,0,0,0,0,1,"DataOne",1,0,0,1
"ek, km",0,0,0,0,0,0,1,"DataOne",1,0,0,1
"ek, mm",0,0,0,0,0,0,1,"DataOne",1,0,0,1
"ek, mw",0,0,0,0,0,0,1,"DataOne",1,0,0,1
"electrofishing",0,0,0,0,0,0,1,"DataOne",1,0,0,1
"elisha kane",0,0,0,0,0,0,1,"DataOne",1,0,0,1
"elm",0,0,0,0,0,0,1,"DataOne",1,0,0,1
"elusive",0,0,0,0,0,0,1,"DataOne",1,0,0,1
"em_fuse",0,0,0,0,0,0,1,"DataOne",1,0,0,1
"emap",0,0,0,0,0,0,1,"DataOne",1,0,0,1
"emergent",0,0,0,0,0,0,1,"DataOne",1,0,0,1
"emergent macrophytes",0,0,0,0,0,0,1,"DataOne",1,0,0,1
"emmonak, y-k delta",0,0,0,0,0,0,1,"DataOne",1,0,0,1
"empididae",0,0,0,0,0,0,1,"DataOne",1,0,0,1
"empty",0,0,0,0,0,0,1,"DataOne",1,0,0,1
"encelia californica",0,0,0,0,0,0,1,"DataOne",1,0,0,1
"endeavor",0,0,0,0,0,0,1,"DataOne",1,0,0,1
"eor pt",0,0,0,0,0,0,1,"DataOne",1,0,0,1
"epa vanveen",0,0,0,0,0,0,1,"DataOne",1,0,0,1
"epc",0,0,0,0,0,0,1,"DataOne",1,0,0,1
"ephemeroptera",0,0,0,0,0,0,1,"DataOne",1,0,0,1
"epithelial cells",0,0,0,0,0,0,1,"DataOne",1,0,0,1
"eq. ratio",0,0,0,0,0,0,1,"DataOne",1,0,0,1
"equivalent freshwater",0,0,0,0,0,0,1,"DataOne",1,0,0,1
"er",0,0,0,0,0,0,1,"DataOne",1,0,0,1
"er_ppm_ms_st",0,0,0,0,0,0,1,"DataOne",1,0,0,1
"er_ppm_ms_st_ree",0,0,0,0,0,0,1,"DataOne",1,0,0,1
"erosion or nondeposition",0,0,0,0,0,0,1,"DataOne",1,0,0,1
"es_q",0,0,0,0,0,0,1,"DataOne",1,0,0,1
"estero",0,0,0,0,0,0,1,"DataOne",1,0,0,1
"etd",0,0,0,0,0,0,1,"DataOne",1,0,0,1
"etheostoma olmstedi",0,0,0,0,0,0,1,"DataOne",1,0,0,1
"etheostoma zonale",0,0,0,0,0,0,1,"DataOne",1,0,0,1
"eu",0,0,0,0,0,0,1,"DataOne",1,0,0,1
"eu_ppm_ms_st",0,0,0,0,0,0,1,"DataOne",1,0,0,1
"eu_ppm_ms_st_ree",0,0,0,0,0,0,1,"DataOne",1,0,0,1
"eu_ppm_na_lc",0,0,0,0,0,0,1,"DataOne",1,0,0,1
"eu_ppm_na_sc",0,0,0,0,0,0,1,"DataOne",1,0,0,1
"eulachon",0,0,0,0,0,0,1,"DataOne",1,0,0,1
"eupelmidae",0,0,0,0,0,0,1,"DataOne",1,0,0,1
"euphausia pacifica",0,0,0,0,0,0,1,"DataOne",1,0,0,1
"euphausiid",0,0,0,0,0,0,1,"DataOne",1,0,0,1
"eurasia",0,0,0,0,0,0,1,"DataOne",1,0,0,1
"evaporation pond",0,0,0,0,0,0,1,"DataOne",1,0,0,1
"ewing piston core",0,0,0,0,0,0,1,"DataOne",1,0,0,1
"example 310b",0,0,0,0,0,0,1,"DataOne",1,0,0,1
"example: ""scn###.sc.tif""",0,0,0,0,0,0,1,"DataOne",1,0,0,1
"exit creek active braid plain",0,0,0,0,0,0,1,"DataOne",1,0,0,1
"exit creek inactive braid plain",0,0,0,0,0,0,1,"DataOne",1,0,0,1
"exit creek transitional braid plain",0,0,0,0,0,0,1,"DataOne",1,0,0,1
"exoglossum maxillingua",0,0,0,0,0,0,1,"DataOne",1,0,0,1
"exposed glacial drift",0,0,0,0,0,0,1,"DataOne",1,0,0,1
"exposed to n. salmincola",0,0,0,0,0,0,1,"DataOne",1,0,0,1
"eywa",0,0,0,0,0,0,1,"DataOne",1,0,0,1
"f, degrees fahrenheit",0,0,0,0,0,0,1,"DataOne",1,0,0,1
"f, degrees fahrenheit",0,0,0,0,0,0,1,"DataOne",1,0,0,1
"f. sand",0,0,0,0,0,0,1,"DataOne",1,0,0,1
"f_pct_ise_fuse",0,0,0,0,0,0,1,"DataOne",1,0,0,1
"fa",0,0,0,0,0,0,1,"DataOne",1,0,0,1
"fa_aa",0,0,0,0,0,0,1,"DataOne",1,0,0,1
"fa_aes",0,0,0,0,0,0,1,"DataOne",1,0,0,1
"fa_dc",0,0,0,0,0,0,1,"DataOne",1,0,0,1
"fa_es",0,0,0,0,0,0,1,"DataOne",1,0,0,1
"fa_gv",0,0,0,0,0,0,1,"DataOne",1,0,0,1
"fa_ms_hf",0,0,0,0,0,0,1,"DataOne",1,0,0,1
"fa_na",0,0,0,0,0,0,1,"DataOne",1,0,0,1
"fahrenheit",0,0,0,0,0,0,1,"DataOne",1,0,0,1
"fair",0,0,0,0,0,0,1,"DataOne",1,0,0,1
"fair-to-poor",0,0,0,0,0,0,1,"DataOne",1,0,0,1
"false",0,0,0,0,0,0,1,"DataOne",1,0,0,1
"false",0,0,0,0,0,0,1,"DataOne",1,0,0,1
"farm ford-downstream",0,0,0,0,0,0,1,"DataOne",1,0,0,1
"farm ford-upstream",0,0,0,0,0,0,1,"DataOne",1,0,0,1
"fathoms",0,0,0,0,0,0,1,"DataOne",1,0,0,1
"fe",0,0,0,0,0,0,1,"DataOne",1,0,0,1
"fe_pct_aes_st",0,0,0,0,0,0,1,"DataOne",1,0,0,1
"fe_pct_es_sq",0,0,0,0,0,0,1,"DataOne",1,0,0,1
"fe_pct_na_lc",0,0,0,0,0,0,1,"DataOne",1,0,0,1
"fe_pct_na_sc",0,0,0,0,0,0,1,"DataOne",1,0,0,1
"fe_pct_wdx_fuse",0,0,0,0,0,0,1,"DataOne",1,0,0,1
"feather",0,0,0,0,0,0,1,"DataOne",1,0,0,1
"feature crosses into and digitized on <topo_date> <topo_name> map.",0,0,0,0,0,0,1,"DataOne",1,0,0,1
"feature designated as <ftr_type> from feature on 19xx map.",0,0,0,0,0,0,1,"DataOne",1,0,0,1
"feb",0,0,0,0,0,0,1,"DataOne",1,0,0,1
"fed",0,0,0,0,0,0,1,"DataOne",1,0,0,1
"feet (ft)",0,0,0,0,0,0,1,"DataOne",1,0,0,1
"felsic mylonite",0,0,0,0,0,0,1,"DataOne",1,0,0,1
"female",0,0,0,0,0,0,1,"DataOne",1,0,0,1
"female",0,0,0,0,0,0,1,"DataOne",1,0,0,1
"feo",0,0,0,0,0,0,1,"DataOne",1,0,0,1
"feo_pct_tt_hf",0,0,0,0,0,0,1,"DataOne",1,0,0,1
"ferl94004",0,0,0,0,0,0,1,"DataOne",1,0,0,1
"ferl95012",0,0,0,0,0,0,1,"DataOne",1,0,0,1
"ferl98029",0,0,0,0,0,0,1,"DataOne",1,0,0,1
"ferrel",0,0,0,0,0,0,1,"DataOne",1,0,0,1
"feto3",0,0,0,0,0,0,1,"DataOne",1,0,0,1
"feto3_pct_wdx_fuse",0,0,0,0,0,0,1,"DataOne",1,0,0,1
"ffc",0,0,0,0,0,0,1,"DataOne",1,0,0,1
"fgs site_id listed in otid",0,0,0,0,0,0,1,"DataOne",1,0,0,1
"fgs_may2010",0,0,0,0,0,0,1,"DataOne",1,0,0,1
"fhc",0,0,0,0,0,0,1,"DataOne",1,0,0,1
"fhs",0,0,0,0,0,0,1,"DataOne",1,0,0,1
"fill",0,0,0,0,0,0,1,"DataOne",1,0,0,1
"final shoreline",0,0,0,0,0,0,1,"DataOne",1,0,0,1
"final shoreline uncertainty",0,0,0,0,0,0,1,"DataOne",1,0,0,1
"final shoreline uncertainty plus potential erosion uncertainty",0,0,0,0,0,0,1,"DataOne",1,0,0,1
"fine-grained substrate",0,0,0,0,0,0,1,"DataOne",1,0,0,1
"fine coarse sand",0,0,0,0,0,0,1,"DataOne",1,0,0,1
"fine gravel",0,0,0,0,0,0,1,"DataOne",1,0,0,1
"fine sand",0,0,0,0,0,0,1,"DataOne",1,0,0,1
"fine sand and gravel",0,0,0,0,0,0,1,"DataOne",1,0,0,1
"fine sand and shells",0,0,0,0,0,0,1,"DataOne",1,0,0,1
"finland vantaa river",0,0,0,0,0,0,1,"DataOne",1,0,0,1
"first 2 digits = hour and last 2 digits = minutes.",0,0,0,0,0,0,1,"DataOne",1,0,0,1
"fish",0,0,0,0,0,0,1,"DataOne",1,0,0,1
"fish egg",0,0,0,0,0,0,1,"DataOne",1,0,0,1
"fishcpue",0,0,0,0,0,0,1,"DataOne",1,0,0,1
"fishltsim",0,0,0,0,0,0,1,"DataOne",1,0,0,1
"fishrich",0,0,0,0,0,0,1,"DataOne",1,0,0,1
"fl_acid_p",0,0,0,0,0,0,1,"DataOne",1,0,0,1
"fl_hf",0,0,0,0,0,0,1,"DataOne",1,0,0,1
"fl_hno3",0,0,0,0,0,0,1,"DataOne",1,0,0,1
"flat",0,0,0,0,0,0,1,"DataOne",1,0,0,1
"fluff sample",0,0,0,0,0,0,1,"DataOne",1,0,0,1
"flwsc_may2010_data",0,0,0,0,0,0,1,"DataOne",1,0,0,1
"fo",0,0,0,0,0,0,1,"DataOne",1,0,0,1
"fold",0,0,0,0,0,0,1,"DataOne",1,0,0,1
"folger_etal1975",0,0,0,0,0,0,1,"DataOne",1,0,0,1
"folk",0,0,0,0,0,0,1,"DataOne",1,0,0,1
"folk1980",0,0,0,0,0,0,1,"DataOne",1,0,0,1
"foot (ngvd 88)",0,0,0,0,0,0,1,"DataOne",1,0,0,1
"foot (ngvd 88)",0,0,0,0,0,0,1,"DataOne",1,0,0,1
"forest",0,0,0,0,0,0,1,"DataOne",1,0,0,1
"forestshrub",0,0,0,0,0,0,1,"DataOne",1,0,0,1
"formazin nephelometric units (fnu)",0,0,0,0,0,0,1,"DataOne",1,0,0,1
"free-fall core",0,0,0,0,0,0,1,"DataOne",1,0,0,1
"freshwater",0,0,0,0,0,0,1,"DataOne",1,0,0,1
"frnl82-7",0,0,0,0,0,0,1,"DataOne",1,0,0,1
"frnl85-1",0,0,0,0,0,0,1,"DataOne",1,0,0,1
"frnl85-2",0,0,0,0,0,0,1,"DataOne",1,0,0,1
"frnl85-3",0,0,0,0,0,0,1,"DataOne",1,0,0,1
"fstr04010",0,0,0,0,0,0,1,"DataOne",1,0,0,1
"ft3/sec",0,0,0,0,0,0,1,"DataOne",1,0,0,1
"fulica alai (hawaiian coot)",0,0,0,0,0,0,1,"DataOne",1,0,0,1
"fundulus diaphanus",0,0,0,0,0,0,1,"DataOne",1,0,0,1
"furrows",0,0,0,0,0,0,1,"DataOne",1,0,0,1
"furrows",0,0,0,0,0,0,1,"DataOne",1,0,0,1
"fusitriton oregonensis",0,0,0,0,0,0,1,"DataOne",1,0,0,1
"future",0,0,0,0,0,0,1,"DataOne",1,0,0,1
"g/1000cm3",0,0,0,0,0,0,1,"DataOne",1,0,0,1
"g/mm",0,0,0,0,0,0,1,"DataOne",1,0,0,1
"g4020",0,0,0,0,0,0,1,"DataOne",1,0,0,1
"ga",0,0,0,0,0,0,1,"DataOne",1,0,0,1
"ga_ppm_es_sq",0,0,0,0,0,0,1,"DataOne",1,0,0,1
"ga_ppm_ms_st",0,0,0,0,0,0,1,"DataOne",1,0,0,1
"gadus chalcogrammus",0,0,0,0,0,0,1,"DataOne",1,0,0,1
"gallinula galeata sandvicensis (hawaiian gallinule)",0,0,0,0,0,0,1,"DataOne",1,0,0,1
"gammaridae",0,0,0,0,0,0,1,"DataOne",1,0,0,1
"garrison",0,0,0,0,0,0,1,"DataOne",1,0,0,1
"garrison66",0,0,0,0,0,0,1,"DataOne",1,0,0,1
"gas",0,0,0,0,0,0,1,"DataOne",1,0,0,1
"gastropoda",0,0,0,0,0,0,1,"DataOne",1,0,0,1
"gaviiformes",0,0,0,0,0,0,1,"DataOne",1,0,0,1
"gawsc_may2010_data",0,0,0,0,0,0,1,"DataOne",1,0,0,1
"gc",0,0,0,0,0,0,1,"DataOne",1,0,0,1
"gd",0,0,0,0,0,0,1,"DataOne",1,0,0,1
"gd_ppm_ms_st",0,0,0,0,0,0,1,"DataOne",1,0,0,1
"gd_ppm_ms_st_ree",0,0,0,0,0,0,1,"DataOne",1,0,0,1
"ge",0,0,0,0,0,0,1,"DataOne",1,0,0,1
"ge_ppm_es_sq",0,0,0,0,0,0,1,"DataOne",1,0,0,1
"ge_ppm_ms_st",0,0,0,0,0,0,1,"DataOne",1,0,0,1
"genbank accession number",0,0,0,0,0,0,1,"DataOne",1,0,0,1
"genbank accession number",0,0,0,0,0,0,1,"DataOne",1,0,0,1
"genesee formation",0,0,0,0,0,0,1,"DataOne",1,0,0,1
"geneseo shale member",0,0,0,0,0,0,1,"DataOne",1,0,0,1
"geologic survey of alabama (gsa)",0,0,0,0,0,0,1,"DataOne",1,0,0,1
"geotech refridgerated van: re02",0,0,0,0,0,0,1,"DataOne",1,0,0,1
"ghf",0,0,0,0,0,0,1,"DataOne",1,0,0,1
"giant box core",0,0,0,0,0,0,1,"DataOne",1,0,0,1
"giant piston core",0,0,0,0,0,0,1,"DataOne",1,0,0,1
"gillnet",0,0,0,0,0,0,1,"DataOne",1,0,0,1
"gl",0,0,0,0,0,0,1,"DataOne",1,0,0,1
"glaciolacustrine",0,0,0,0,0,0,1,"DataOne",1,0,0,1
"glhe2",0,0,0,0,0,0,1,"DataOne",1,0,0,1
"glomar conception",0,0,0,0,0,0,1,"DataOne",1,0,0,1
"gloria michelle",0,0,0,0,0,0,1,"DataOne",1,0,0,1
"glory hole",0,0,0,0,0,0,1,"DataOne",1,0,0,1
"gly",0,0,0,0,0,0,1,"DataOne",1,0,0,1
"goea",0,0,0,0,0,0,1,"DataOne",1,0,0,1
"golden bay, port wells",0,0,0,0,0,0,1,"DataOne",1,0,0,1
"golden shiner",0,0,0,0,0,0,1,"DataOne",1,0,0,1
"gpc",0,0,0,0,0,0,1,"DataOne",1,0,0,1
"gpm, gallons per minute",0,0,0,0,0,0,1,"DataOne",1,0,0,1
"gpo",0,0,0,0,0,0,1,"DataOne",1,0,0,1
"gr",0,0,0,0,0,0,1,"DataOne",1,0,0,1
"gr-sd",0,0,0,0,0,0,1,"DataOne",1,0,0,1
"grab",0,0,0,0,0,0,1,"DataOne",1,0,0,1
"grabs",0,0,0,0,0,0,1,"DataOne",1,0,0,1
"gramperday",0,0,0,0,0,0,1,"DataOne",1,0,0,1
"grams",0,0,0,0,0,0,1,"DataOne",1,0,0,1
"grams oxygen per meter square per day",0,0,0,0,0,0,1,"DataOne",1,0,0,1
"grams per centimeter cubed",0,0,0,0,0,0,1,"DataOne",1,0,0,1
"grams per cubic centimeter (g/cc)",0,0,0,0,0,0,1,"DataOne",1,0,0,1
"grams per cubic cm",0,0,0,0,0,0,1,"DataOne",1,0,0,1
"grams per meter squared per year (g m2/yr)",0,0,0,0,0,0,1,"DataOne",1,0,0,1
"grams/cm^2",0,0,0,0,0,0,1,"DataOne",1,0,0,1
"grams/mete",0,0,0,0,0,0,1,"DataOne",1,0,0,1
"gramscarbonpersquaremeterperhour",0,0,0,0,0,0,1,"DataOne",1,0,0,1
"gramsperkillogram",0,0,0,0,0,0,1,"DataOne",1,0,0,1
"gramspersquaremeterperday",0,0,0,0,0,0,1,"DataOne",1,0,0,1
"granite",0,0,0,0,0,0,1,"DataOne",1,0,0,1
"granite island",0,0,0,0,0,0,1,"DataOne",1,0,0,1
"granitoid",0,0,0,0,0,0,1,"DataOne",1,0,0,1
"granodiorite",0,0,0,0,0,0,1,"DataOne",1,0,0,1
"grass",0,0,0,0,0,0,1,"DataOne",1,0,0,1
"grass/shrub",0,0,0,0,0,0,1,"DataOne",1,0,0,1
"grasses - moist soil grasses (e.g., reed canary grass, rice cutgrass) with inclusions of mixed emergents and/or forbs",0,0,0,0,0,0,1,"DataOne",1,0,0,1
"grassle",0,0,0,0,0,0,1,"DataOne",1,0,0,1
"gravel",0,0,0,0,0,0,1,"DataOne",1,0,0,1
"gravel-sand",0,0,0,0,0,0,1,"DataOne",1,0,0,1
"gravel >10%",0,0,0,0,0,0,1,"DataOne",1,0,0,1
"gravel pit",0,0,0,0,0,0,1,"DataOne",1,0,0,1
"gravel, silt-clay",0,0,0,0,0,0,1,"DataOne",1,0,0,1
"gravel/borrow pit - undifferentiated",0,0,0,0,0,0,1,"DataOne",1,0,0,1
"gravelly",0,0,0,0,0,0,1,"DataOne",1,0,0,1
"gravelly pavement",0,0,0,0,0,0,1,"DataOne",1,0,0,1
"gravelly sediment",0,0,0,0,0,0,1,"DataOne",1,0,0,1
"gravelly sediment",0,0,0,0,0,0,1,"DataOne",1,0,0,1
"gravity core",0,0,0,0,0,0,1,"DataOne",1,0,0,1
"gravity core",0,0,0,0,0,0,1,"DataOne",1,0,0,1
"gravity heat flow core",0,0,0,0,0,0,1,"DataOne",1,0,0,1
"gravity/flux core",0,0,0,0,0,0,1,"DataOne",1,0,0,1
"grays harbor",0,0,0,0,0,0,1,"DataOne",1,0,0,1
"grc",0,0,0,0,0,0,1,"DataOne",1,0,0,1
"great round shoal",0,0,0,0,0,0,1,"DataOne",1,0,0,1
"greenbrier limestone",0,0,0,0,0,0,1,"DataOne",1,0,0,1
"gregg basin",0,0,0,0,0,0,1,"DataOne",1,0,0,1
"gregorian calendar year (ce)",0,0,0,0,0,0,1,"DataOne",1,0,0,1
"grnd sht",0,0,0,0,0,0,1,"DataOne",1,0,0,1
"grooming",0,0,0,0,0,0,1,"DataOne",1,0,0,1
"ground gps survey",0,0,0,0,0,0,1,"DataOne",1,0,0,1
"gruiformes",0,0,0,0,0,0,1,"DataOne",1,0,0,1
"gulf of maine",0,0,0,0,0,0,1,"DataOne",1,0,0,1
"gull",0,0,0,0,0,0,1,"DataOne",1,0,0,1
"gupd",0,0,0,0,0,0,1,"DataOne",1,0,0,1
"gv_cr",0,0,0,0,0,0,1,"DataOne",1,0,0,1
"gv_flux",0,0,0,0,0,0,1,"DataOne",1,0,0,1
"gv_hcl",0,0,0,0,0,0,1,"DataOne",1,0,0,1
"gv_wo",0,0,0,0,0,0,1,"DataOne",1,0,0,1
"gwgu",0,0,0,0,0,0,1,"DataOne",1,0,0,1
"gyre",0,0,0,0,0,0,1,"DataOne",1,0,0,1
"gyre97-6",0,0,0,0,0,0,1,"DataOne",1,0,0,1
"h11997",0,0,0,0,0,0,1,"DataOne",1,0,0,1
"h2o",0,0,0,0,0,0,1,"DataOne",1,0,0,1
"h2o_pct_tt_flux",0,0,0,0,0,0,1,"DataOne",1,0,0,1
"h2ob",0,0,0,0,0,0,1,"DataOne",1,0,0,1
"h2ob_pct_tt_flux",0,0,0,0,0,0,1,"DataOne",1,0,0,1
"h2om",0,0,0,0,0,0,1,"DataOne",1,0,0,1
"h2om_pct_gv",0,0,0,0,0,0,1,"DataOne",1,0,0,1
"h4",0,0,0,0,0,0,1,"DataOne",1,0,0,1
"h5",0,0,0,0,0,0,1,"DataOne",1,0,0,1
"h6",0,0,0,0,0,0,1,"DataOne",1,0,0,1
"h90_100_1014",0,0,0,0,0,0,1,"DataOne",1,0,0,1
"h90_200",0,0,0,0,0,0,1,"DataOne",1,0,0,1
"h91_all",0,0,0,0,0,0,1,"DataOne",1,0,0,1
"h92_100_1014",0,0,0,0,0,0,1,"DataOne",1,0,0,1
"h92_100_s329",0,0,0,0,0,0,1,"DataOne",1,0,0,1
"h92_200_1014_edgetech",0,0,0,0,0,0,1,"DataOne",1,0,0,1
"h92_200_1014_klein",0,0,0,0,0,0,1,"DataOne",1,0,0,1
"h94_200_s329",0,0,0,0,0,0,1,"DataOne",1,0,0,1
"h94_2392",0,0,0,0,0,0,1,"DataOne",1,0,0,1
"h94_2930",0,0,0,0,0,0,1,"DataOne",1,0,0,1
"h94_2931",0,0,0,0,0,0,1,"DataOne",1,0,0,1
"hachures",0,0,0,0,0,0,1,"DataOne",1,0,0,1
"hadley mc1",0,0,0,0,0,0,1,"DataOne",1,0,0,1
"haida gwaii",0,0,0,0,0,0,1,"DataOne",1,0,0,1
"hamilton group",0,0,0,0,0,0,1,"DataOne",1,0,0,1
"hamma hamma",0,0,0,0,0,0,1,"DataOne",1,0,0,1
"hard-bottom plains",0,0,0,0,0,0,1,"DataOne",1,0,0,1
"hardground",0,0,0,0,0,0,1,"DataOne",1,0,0,1
"harpacticoida",0,0,0,0,0,0,1,"DataOne",1,0,0,1
"harrell shale",0,0,0,0,0,0,1,"DataOne",1,0,0,1
"harris, a.g., and others, 1994",0,0,0,0,0,0,1,"DataOne",1,0,0,1
"hatch",0,0,0,0,0,0,1,"DataOne",1,0,0,1
"hatch",0,0,0,0,0,0,1,"DataOne",1,0,0,1
"hathaway",0,0,0,0,0,0,1,"DataOne",1,0,0,1
"hauling out of water",0,0,0,0,0,0,1,"DataOne",1,0,0,1
"hazartia",0,0,0,0,0,0,1,"DataOne",1,0,0,1
"hazel alder",0,0,0,0,0,0,1,"DataOne",1,0,0,1
"hbr-br2",0,0,0,0,0,0,1,"DataOne",1,0,0,1
"hcl-h2o2",0,0,0,0,0,0,1,"DataOne",1,0,0,1
"hclo4",0,0,0,0,0,0,1,"DataOne",1,0,0,1
"hdc",0,0,0,0,0,0,1,"DataOne",1,0,0,1
"head shake",0,0,0,0,0,0,1,"DataOne",1,0,0,1
"hectopascal (hpa)",0,0,0,0,0,0,1,"DataOne",1,0,0,1
"height",0,0,0,0,0,0,1,"DataOne",1,0,0,1
"hemipelagic",0,0,0,0,0,0,1,"DataOne",1,0,0,1
"hemiptera",0,0,0,0,0,0,1,"DataOne",1,0,0,1
"herbivore",0,0,0,0,0,0,1,"DataOne",1,0,0,1
"herring",0,0,0,0,0,0,1,"DataOne",1,0,0,1
"herring bay",0,0,0,0,0,0,1,"DataOne",1,0,0,1
"hertz",0,0,0,0,0,0,1,"DataOne",1,0,0,1
"hf",0,0,0,0,0,0,1,"DataOne",1,0,0,1
"hf-h2so4",0,0,0,0,0,0,1,"DataOne",1,0,0,1
"hf_ppm_ms_st",0,0,0,0,0,0,1,"DataOne",1,0,0,1
"hf_ppm_na_lc",0,0,0,0,0,0,1,"DataOne",1,0,0,1
"hf_ppm_na_sc",0,0,0,0,0,0,1,"DataOne",1,0,0,1
"hg",0,0,0,0,0,0,1,"DataOne",1,0,0,1
"hg",0,0,0,0,0,0,1,"DataOne",1,0,0,1
"hg_ppm_aa_cv",0,0,0,0,0,0,1,"DataOne",1,0,0,1
"hh:mm",0,0,0,0,0,0,1,"DataOne",1,0,0,1
"hh:mm:ss",0,0,0,0,0,0,1,"DataOne",1,0,0,1
"hh:mm:ss.ss",0,0,0,0,0,0,1,"DataOne",1,0,0,1
"high heat load",0,0,0,0,0,0,1,"DataOne",1,0,0,1
"highbkstr",0,0,0,0,0,0,1,"DataOne",1,0,0,1
"higher",0,0,0,0,0,0,1,"DataOne",1,0,0,1
"historical cliff retreat rate (m/yr)",0,0,0,0,0,0,1,"DataOne",1,0,0,1
"historical cliff retreat rate uncertainty (m/yr)",0,0,0,0,0,0,1,"DataOne",1,0,0,1
"hnd",0,0,0,0,0,0,1,"DataOne",1,0,0,1
"ho",0,0,0,0,0,0,1,"DataOne",1,0,0,1
"ho_ppm_ms_st",0,0,0,0,0,0,1,"DataOne",1,0,0,1
"ho_ppm_ms_st_ree",0,0,0,0,0,0,1,"DataOne",1,0,0,1
"holkums branch",0,0,0,0,0,0,1,"DataOne",1,0,0,1
"hollister-whoi",0,0,0,0,0,0,1,"DataOne",1,0,0,1
"hollister1969",0,0,0,0,0,0,1,"DataOne",1,0,0,1
"holocene - surficial sedimentary deposits",0,0,0,0,0,0,1,"DataOne",1,0,0,1
"hooper bay, y-k delta",0,0,0,0,0,0,1,"DataOne",1,0,0,1
"hope bay",0,0,0,0,0,0,1,"DataOne",1,0,0,1
"hopeb",0,0,0,0,0,0,1,"DataOne",1,0,0,1
"horton river",0,0,0,0,0,0,1,"DataOne",1,0,0,1
"hot spring _f",0,0,0,0,0,0,1,"DataOne",1,0,0,1
"hot spring _p",0,0,0,0,0,0,1,"DataOne",1,0,0,1
"hough40",0,0,0,0,0,0,1,"DataOne",1,0,0,1
"hough42",0,0,0,0,0,0,1,"DataOne",1,0,0,1
"hour - 24-hr day",0,0,0,0,0,0,1,"DataOne",1,0,0,1
"hour - 24-hr day",0,0,0,0,0,0,1,"DataOne",1,0,0,1
"hour of day (24-hr clock)",0,0,0,0,0,0,1,"DataOne",1,0,0,1
"hours (24-hour clock)",0,0,0,0,0,0,1,"DataOne",1,0,0,1
"hours, minutes, seconds in the format hh:mm:ss",0,0,0,0,0,0,1,"DataOne",1,0,0,1
"hours:minutes:seconds",0,0,0,0,0,0,1,"DataOne",1,0,0,1
"hr",0,0,0,0,0,0,1,"DataOne",1,0,0,1
"hsc",0,0,0,0,0,0,1,"DataOne",1,0,0,1
"hudson",0,0,0,0,0,0,1,"DataOne",1,0,0,1
"humans",0,0,0,0,0,0,1,"DataOne",1,0,0,1
"huron member",0,0,0,0,0,0,1,"DataOne",1,0,0,1
"hurricane irma 2017",0,0,0,0,0,0,1,"DataOne",1,0,0,1
"hurricane maria 2017",0,0,0,0,0,0,1,"DataOne",1,0,0,1
"hurricane nate 2017",0,0,0,0,0,0,1,"DataOne",1,0,0,1
"hydrachnidia",0,0,0,0,0,0,1,"DataOne",1,0,0,1
"hydraulic mine",0,0,0,0,0,0,1,"DataOne",1,0,0,1
"hydraulically damped corer w/o piston",0,0,0,0,0,0,1,"DataOne",1,0,0,1
"hydraulically damped slow core",0,0,0,0,0,0,1,"DataOne",1,0,0,1
"hymenoptera",0,0,0,0,0,0,1,"DataOne",1,0,0,1
"hypentelium nigricans",0,0,0,0,0,0,1,"DataOne",1,0,0,1
"ic",0,0,0,0,0,0,1,"DataOne",1,0,0,1
"ic_st",0,0,0,0,0,0,1,"DataOne",1,0,0,1
"ice",0,0,0,0,0,0,1,"DataOne",1,0,0,1
"ichneumonidae",0,0,0,0,0,0,1,"DataOne",1,0,0,1
"ictalurus punctatus",0,0,0,0,0,0,1,"DataOne",1,0,0,1
"id number",0,0,0,0,0,0,1,"DataOne",1,0,0,1
"id010 sugar down",0,0,0,0,0,0,1,"DataOne",1,0,0,1
"id018 sugar mid",0,0,0,0,0,0,1,"DataOne",1,0,0,1
"id019 cinnabar",0,0,0,0,0,0,1,"DataOne",1,0,0,1
"id020 sugar up",0,0,0,0,0,0,1,"DataOne",1,0,0,1
"id021 cane",0,0,0,0,0,0,1,"DataOne",1,0,0,1
"identification code for labsite used to run diagnostic tests",0,0,0,0,0,0,1,"DataOne",1,0,0,1
"iem",0,0,0,0,0,0,1,"DataOne",1,0,0,1
"iku",0,0,0,0,0,0,1,"DataOne",1,0,0,1
"imca",0,0,0,0,0,0,1,"DataOne",1,0,0,1
"immature (juvenile)",0,0,0,0,0,0,1,"DataOne",1,0,0,1
"immobile sediment",0,0,0,0,0,0,1,"DataOne",1,0,0,1
"in",0,0,0,0,0,0,1,"DataOne",1,0,0,1
"in_ppm_ms_st",0,0,0,0,0,0,1,"DataOne",1,0,0,1
"increase in smz july ndvi corresponding to a 1-unit increase in 90-day (april-june) cumulative antecedent precipitation",0,0,0,0,0,0,1,"DataOne",1,0,0,1
"increase in smz july ndvi corresponding to a 1-unit increase in previous winter's snowpack",0,0,0,0,0,0,1,"DataOne",1,0,0,1
"incremental svp station identification",0,0,0,0,0,0,1,"DataOne",1,0,0,1
"incremental svp station identification",0,0,0,0,0,0,1,"DataOne",1,0,0,1
"index - an annual-scale index of drought severity known as the self calibrated palmer drought severity index (scpdsi)",0,0,0,0,0,0,1,"DataOne",1,0,0,1
"index number",0,0,0,0,0,0,1,"DataOne",1,0,0,1
"index units",0,0,0,0,0,0,1,"DataOne",1,0,0,1
"indian wells",0,0,0,0,0,0,1,"DataOne",1,0,0,1
"indicates the group affiliation (e.g. fws) for the person who contacted the center about the mortality event.",0,0,0,0,0,0,1,"DataOne",1,0,0,1
"indicator of specific type of work, e.g. national wildlife refuge (nwr) or zoo",0,0,0,0,0,0,1,"DataOne",1,0,0,1
"indicator of type of agency or organization for tracking purposes, e.g. fws or state, municipal or territorial agency",0,0,0,0,0,0,1,"DataOne",1,0,0,1
"individual bird",0,0,0,0,0,0,1,"DataOne",1,0,0,1
"individual experiment number (arbitrary value)",0,0,0,0,0,0,1,"DataOne",1,0,0,1
"individual fish",0,0,0,0,0,0,1,"DataOne",1,0,0,1
"individual organism",0,0,0,0,0,0,1,"DataOne",1,0,0,1
"individual otter",0,0,0,0,0,0,1,"DataOne",1,0,0,1
"infectious",0,0,0,0,0,0,1,"DataOne",1,0,0,1
"inferred",0,0,0,0,0,0,1,"DataOne",1,0,0,1
"inferred <ftr_type> from adjacent feature.",0,0,0,0,0,0,1,"DataOne",1,0,0,1
"initial shoreline",0,0,0,0,0,0,1,"DataOne",1,0,0,1
"initials identifying nwhc contact for the mortality event.",0,0,0,0,0,0,1,"DataOne",1,0,0,1
"initials of user who last updated the record",0,0,0,0,0,0,1,"DataOne",1,0,0,1
"injection",0,0,0,0,0,0,1,"DataOne",1,0,0,1
"inlet-associated shoal",0,0,0,0,0,0,1,"DataOne",1,0,0,1
"insecta",0,0,0,0,0,0,1,"DataOne",1,0,0,1
"inst",0,0,0,0,0,0,1,"DataOne",1,0,0,1
"integer from 1-12 coding for months january-december",0,0,0,0,0,0,1,"DataOne",1,0,0,1
"integer ranging from 2002-2015 (yyyy)",0,0,0,0,0,0,1,"DataOne",1,0,0,1
"integer values -10 to -60 representing depth intervals as described above.",0,0,0,0,0,0,1,"DataOne",1,0,0,1
"integer values -10 to -80 representing depth intervals as described above.",0,0,0,0,0,0,1,"DataOne",1,0,0,1
"integers - number of individuals",0,0,0,0,0,0,1,"DataOne",1,0,0,1
"integers - number of species",0,0,0,0,0,0,1,"DataOne",1,0,0,1
"integers (counts)",0,0,0,0,0,0,1,"DataOne",1,0,0,1
"interacting",0,0,0,0,0,0,1,"DataOne",1,0,0,1
"interocean seaboss (osprey config)",0,0,0,0,0,0,1,"DataOne",1,0,0,1
"interp",0,0,0,0,0,0,1,"DataOne",1,0,0,1
"interval",0,0,0,0,0,0,1,"DataOne",1,0,0,1
"intradeposit",0,0,0,0,0,0,1,"DataOne",1,0,0,1
"invertebrate",0,0,0,0,0,0,1,"DataOne",1,0,0,1
"invltsim",0,0,0,0,0,0,1,"DataOne",1,0,0,1
"invpeptrich",0,0,0,0,0,0,1,"DataOne",1,0,0,1
"invrich",0,0,0,0,0,0,1,"DataOne",1,0,0,1
"iplover-assateague_island",0,0,0,0,0,0,1,"DataOne",1,0,0,1
"iplover-cape_lookout",0,0,0,0,0,0,1,"DataOne",1,0,0,1
"iplover-chincoteague",0,0,0,0,0,0,1,"DataOne",1,0,0,1
"iplover-eastern_shore_virginia",0,0,0,0,0,0,1,"DataOne",1,0,0,1
"iplover-field",0,0,0,0,0,0,1,"DataOne",1,0,0,1
"iplover-fire_island",0,0,0,0,0,0,1,"DataOne",1,0,0,1
"iplover-jamaica_bay",0,0,0,0,0,0,1,"DataOne",1,0,0,1
"iplover-maine",0,0,0,0,0,0,1,"DataOne",1,0,0,1
"iplover-marthas_vineyard",0,0,0,0,0,0,1,"DataOne",1,0,0,1
"iplover-massachusetts",0,0,0,0,0,0,1,"DataOne",1,0,0,1
"iplover-monomoy_island",0,0,0,0,0,0,1,"DataOne",1,0,0,1
"iplover-new_jersey",0,0,0,0,0,0,1,"DataOne",1,0,0,1
"iplover-north_carolina",0,0,0,0,0,0,1,"DataOne",1,0,0,1
"iplover-parker_river",0,0,0,0,0,0,1,"DataOne",1,0,0,1
"iplover-r_and_d",0,0,0,0,0,0,1,"DataOne",1,0,0,1
"iplover-rachel_carson",0,0,0,0,0,0,1,"DataOne",1,0,0,1
"iplover-rhode_island",0,0,0,0,0,0,1,"DataOne",1,0,0,1
"iplover-tnc_virginia_coast",0,0,0,0,0,0,1,"DataOne",1,0,0,1
"ir",0,0,0,0,0,0,1,"DataOne",1,0,0,1
"ir_ppm_fa_ms",0,0,0,0,0,0,1,"DataOne",1,0,0,1
"iris",0,0,0,0,0,0,1,"DataOne",1,0,0,1
"iron pit",0,0,0,0,0,0,1,"DataOne",1,0,0,1
"irrigated croplands",0,0,0,0,0,0,1,"DataOne",1,0,0,1
"isabel s",0,0,0,0,0,0,1,"DataOne",1,0,0,1
"isbl96037",0,0,0,0,0,0,1,"DataOne",1,0,0,1
"isbl98017",0,0,0,0,0,0,1,"DataOne",1,0,0,1
"j booth",0,0,0,0,0,0,1,"DataOne",1,0,0,1
"j. chaytor",0,0,0,0,0,0,1,"DataOne",1,0,0,1
"j3",0,0,0,0,0,0,1,"DataOne",1,0,0,1
"java formation",0,0,0,0,0,0,1,"DataOne",1,0,0,1
"jchaytor",0,0,0,0,0,0,1,"DataOne",1,0,0,1
"jefferson",0,0,0,0,0,0,1,"DataOne",1,0,0,1
"jenkins creek, wa",0,0,0,0,0,0,1,"DataOne",1,0,0,1
"johnson/ jsl",0,0,0,0,0,0,1,"DataOne",1,0,0,1
"johnstonetal1994",0,0,0,0,0,0,1,"DataOne",1,0,0,1
"jonah",0,0,0,0,0,0,1,"DataOne",1,0,0,1
"juga spp.",0,0,0,0,0,0,1,"DataOne",1,0,0,1
"juga spp. observed at the sample site",0,0,0,0,0,0,1,"DataOne",1,0,0,1
"julian day data were collected where julian day is the integer number representing the interval of time in days since january 1 of the year of collection.",0,0,0,0,0,0,1,"DataOne",1,0,0,1
"julian day.",0,0,0,0,0,0,1,"DataOne",1,0,0,1
"july",0,0,0,0,0,0,1,"DataOne",1,0,0,1
"jumping",0,0,0,0,0,0,1,"DataOne",1,0,0,1
"juni",0,0,0,0,0,0,1,"DataOne",1,0,0,1
"juvenile steelhead (rbt) *",0,0,0,0,0,0,1,"DataOne",1,0,0,1
"juvenile steelhead (rbt) 2",0,0,0,0,0,0,1,"DataOne",1,0,0,1
"juvenile steelhead (rbt) 3",0,0,0,0,0,0,1,"DataOne",1,0,0,1
"juvenile tailed frog (jtf) 14",0,0,0,0,0,0,1,"DataOne",1,0,0,1
"juvenile tailed frog (jtf) 16",0,0,0,0,0,0,1,"DataOne",1,0,0,1
"juvenile tailed frog (jtf) 3",0,0,0,0,0,0,1,"DataOne",1,0,0,1
"juvenile tailed frog (jtf) 5",0,0,0,0,0,0,1,"DataOne",1,0,0,1
"juvenile tailed frogs (jtf) 5",0,0,0,0,0,0,1,"DataOne",1,0,0,1
"juvenile tailed frogs (jtf) 6",0,0,0,0,0,0,1,"DataOne",1,0,0,1
"k/d",0,0,0,0,0,0,1,"DataOne",1,0,0,1
"k/m",0,0,0,0,0,0,1,"DataOne",1,0,0,1
"k_pct_aes_st",0,0,0,0,0,0,1,"DataOne",1,0,0,1
"k_pct_na_lc",0,0,0,0,0,0,1,"DataOne",1,0,0,1
"k_pct_wdx_fuse",0,0,0,0,0,0,1,"DataOne",1,0,0,1
"k1",0,0,0,0,0,0,1,"DataOne",1,0,0,1
"k2o",0,0,0,0,0,0,1,"DataOne",1,0,0,1
"k2o_pct_wdx_fuse",0,0,0,0,0,0,1,"DataOne",1,0,0,1
"kamchatskiy kray",0,0,0,0,0,0,1,"DataOne",1,0,0,1
"kasatochi",0,0,0,0,0,0,1,"DataOne",1,0,0,1
"kasatochi island",0,0,0,0,0,0,1,"DataOne",1,0,0,1
"katmmbm2012",0,0,0,0,0,0,1,"DataOne",1,0,0,1
"katmmbm2013",0,0,0,0,0,0,1,"DataOne",1,0,0,1
"katmmbm2014",0,0,0,0,0,0,1,"DataOne",1,0,0,1
"katmmbm2015",0,0,0,0,0,0,1,"DataOne",1,0,0,1
"katmmbm2016",0,0,0,0,0,0,1,"DataOne",1,0,0,1
"kayak",0,0,0,0,0,0,1,"DataOne",1,0,0,1
"kefjmbm2012",0,0,0,0,0,0,1,"DataOne",1,0,0,1
"kefjmbm2013",0,0,0,0,0,0,1,"DataOne",1,0,0,1
"kefjmbm2014",0,0,0,0,0,0,1,"DataOne",1,0,0,1
"kefjmbm2015",0,0,0,0,0,0,1,"DataOne",1,0,0,1
"kefjmbm2016",0,0,0,0,0,0,1,"DataOne",1,0,0,1
"kenai fjords",0,0,0,0,0,0,1,"DataOne",1,0,0,1
"kentucky",0,0,0,0,0,0,1,"DataOne",1,0,0,1
"kern-02",0,0,0,0,0,0,1,"DataOne",1,0,0,1
"kern-03",0,0,0,0,0,0,1,"DataOne",1,0,0,1
"kernville",0,0,0,0,0,0,1,"DataOne",1,0,0,1
"keyser limestone",0,0,0,0,0,0,1,"DataOne",1,0,0,1
"kf",0,0,0,0,0,0,1,"DataOne",1,0,0,1
"kg/ha/yr",0,0,0,0,0,0,1,"DataOne",1,0,0,1
"kilograms",0,0,0,0,0,0,1,"DataOne",1,0,0,1
"kilohertz (khz)",0,0,0,0,0,0,1,"DataOne",1,0,0,1
"kilojoulepermeter",0,0,0,0,0,0,1,"DataOne",1,0,0,1
"kilojoulesperday",0,0,0,0,0,0,1,"DataOne",1,0,0,1
"kilojoulesperhour",0,0,0,0,0,0,1,"DataOne",1,0,0,1
"kilometers per hour",0,0,0,0,0,0,1,"DataOne",1,0,0,1
"kimu",0,0,0,0,0,0,1,"DataOne",1,0,0,1
"king-30",0,0,0,0,0,0,1,"DataOne",1,0,0,1
"kipnuk, y-k delta",0,0,0,0,0,0,1,"DataOne",1,0,0,1
"kl",0,0,0,0,0,0,1,"DataOne",1,0,0,1
"klam-05",0,0,0,0,0,0,1,"DataOne",1,0,0,1
"klam-25",0,0,0,0,0,0,1,"DataOne",1,0,0,1
"km/d",0,0,0,0,0,0,1,"DataOne",1,0,0,1
"km2/d",0,0,0,0,0,0,1,"DataOne",1,0,0,1
"kmno4-h2so4-hf",0,0,0,0,0,0,1,"DataOne",1,0,0,1
"kn, sp",0,0,0,0,0,0,1,"DataOne",1,0,0,1
"knebel",0,0,0,0,0,0,1,"DataOne",1,0,0,1
"knorr",0,0,0,0,0,0,1,"DataOne",1,0,0,1
"knots",0,0,0,0,0,0,1,"DataOne",1,0,0,1
"kodiak island",0,0,0,0,0,0,1,"DataOne",1,0,0,1
"koniuji",0,0,0,0,0,0,1,"DataOne",1,0,0,1
"kotlik, y-k delta",0,0,0,0,0,0,1,"DataOne",1,0,0,1
"kwethluk, y-k delta",0,0,0,0,0,0,1,"DataOne",1,0,0,1
"kz",0,0,0,0,0,0,1,"DataOne",1,0,0,1
"kz35",0,0,0,0,0,0,1,"DataOne",1,0,0,1
"l/min",0,0,0,0,0,0,1,"DataOne",1,0,0,1
"la",0,0,0,0,0,0,1,"DataOne",1,0,0,1
"la, au, y, s, n, t",0,0,0,0,0,0,1,"DataOne",1,0,0,1
"la,ae,w,x,ab,au, v, t",0,0,0,0,0,0,1,"DataOne",1,0,0,1
"la_ppm_edx",0,0,0,0,0,0,1,"DataOne",1,0,0,1
"la_ppm_es_sq",0,0,0,0,0,0,1,"DataOne",1,0,0,1
"la_ppm_ms_st",0,0,0,0,0,0,1,"DataOne",1,0,0,1
"la_ppm_ms_st_ree",0,0,0,0,0,0,1,"DataOne",1,0,0,1
"la_ppm_na_lc",0,0,0,0,0,0,1,"DataOne",1,0,0,1
"la_ppm_na_sc",0,0,0,0,0,0,1,"DataOne",1,0,0,1
"la70",0,0,0,0,0,0,1,"DataOne",1,0,0,1
"label without symbol. point placed at center of label and feature type inferred from label.",0,0,0,0,0,0,1,"DataOne",1,0,0,1
"label without symbol. point placed on building symbol and feature type inferred from label.",0,0,0,0,0,0,1,"DataOne",1,0,0,1
"labeled as <ftr_type> on 19xx map.",0,0,0,0,0,0,1,"DataOne",1,0,0,1
"labeled as abandoned.",0,0,0,0,0,0,1,"DataOne",1,0,0,1
"labeled as active.",0,0,0,0,0,0,1,"DataOne",1,0,0,1
"labeled as inactive.",0,0,0,0,0,0,1,"DataOne",1,0,0,1
"laca3",0,0,0,0,0,0,1,"DataOne",1,0,0,1
"lake",0,0,0,0,0,0,1,"DataOne",1,0,0,1
"lake athabasca",0,0,0,0,0,0,1,"DataOne",1,0,0,1
"lake name",0,0,0,0,0,0,1,"DataOne",1,0,0,1
"lamar national fish hatchery (pa)",0,0,0,0,0,0,1,"DataOne",1,0,0,1
"lamont peak",0,0,0,0,0,0,1,"DataOne",1,0,0,1
"landfast ice",0,0,0,0,0,0,1,"DataOne",1,0,0,1
"langara island",0,0,0,0,0,0,1,"DataOne",1,0,0,1
"largemouth bass",0,0,0,0,0,0,1,"DataOne",1,0,0,1
"larsen and gaudette 2002",0,0,0,0,0,0,1,"DataOne",1,0,0,1
"larsen03",0,0,0,0,0,0,1,"DataOne",1,0,0,1
"larva",0,0,0,0,0,0,1,"DataOne",1,0,0,1
"last shot along sub-bottom trackline.",0,0,0,0,0,0,1,"DataOne",1,0,0,1
"latest possible",0,0,0,0,0,0,1,"DataOne",1,0,0,1
"latitudelongitude",0,0,0,0,0,0,1,"DataOne",1,0,0,1
"latrine",0,0,0,0,0,0,1,"DataOne",1,0,0,1
"laurel oak",0,0,0,0,0,0,1,"DataOne",1,0,0,1
"laurentian",0,0,0,0,0,0,1,"DataOne",1,0,0,1
"laying",0,0,0,0,0,0,1,"DataOne",1,0,0,1
"lbcap",0,0,0,0,0,0,1,"DataOne",1,0,0,1
"lbdo",0,0,0,0,0,0,1,"DataOne",1,0,0,1
"lbm",0,0,0,0,0,0,1,"DataOne",1,0,0,1
"lbs shoal",0,0,0,0,0,0,1,"DataOne",1,0,0,1
"lc152",0,0,0,0,0,0,1,"DataOne",1,0,0,1
"lcfw",0,0,0,0,0,0,1,"DataOne",1,0,0,1
"ldeo",0,0,0,0,0,0,1,"DataOne",1,0,0,1
"le54",0,0,0,0,0,0,1,"DataOne",1,0,0,1
"leach pond",0,0,0,0,0,0,1,"DataOne",1,0,0,1
"legal-closed, legal-open, not legal, potential legal.",0,0,0,0,0,0,1,"DataOne",1,0,0,1
"lepomis gibbosus",0,0,0,0,0,0,1,"DataOne",1,0,0,1
"lepomis macrochirus",0,0,0,0,0,0,1,"DataOne",1,0,0,1
"lesc",0,0,0,0,0,0,1,"DataOne",1,0,0,1
"let the madness begin",0,0,0,0,0,0,1,"DataOne",1,0,0,1
"levee-lineated",0,0,0,0,0,0,1,"DataOne",1,0,0,1
"levee-low-backscatter",0,0,0,0,0,0,1,"DataOne",1,0,0,1
"levee-mottled",0,0,0,0,0,0,1,"DataOne",1,0,0,1
"lewis",0,0,0,0,0,0,1,"DataOne",1,0,0,1
"lewis ford",0,0,0,0,0,0,1,"DataOne",1,0,0,1
"lf",0,0,0,0,0,0,1,"DataOne",1,0,0,1
"lg17-006-s1",0,0,0,0,0,0,1,"DataOne",1,0,0,1
"lh21",0,0,0,0,0,0,1,"DataOne",1,0,0,1
"li",0,0,0,0,0,0,1,"DataOne",1,0,0,1
"li_ppm_aes_st",0,0,0,0,0,0,1,"DataOne",1,0,0,1
"libo2-li2b4o7 fusion",0,0,0,0,0,0,1,"DataOne",1,0,0,1
"libo2 fusion",0,0,0,0,0,0,1,"DataOne",1,0,0,1
"licking creek limestone",0,0,0,0,0,0,1,"DataOne",1,0,0,1
"light rain",0,0,0,0,0,0,1,"DataOne",1,0,0,1
"light wind",0,0,0,0,0,0,1,"DataOne",1,0,0,1
"light wind; rain; thunder",0,0,0,0,0,0,1,"DataOne",1,0,0,1
"lightcroptree",0,0,0,0,0,0,1,"DataOne",1,0,0,1
"lignite",0,0,0,0,0,0,1,"DataOne",1,0,0,1
"lignite pit",0,0,0,0,0,0,1,"DataOne",1,0,0,1
"limnephilidae",0,0,0,0,0,0,1,"DataOne",1,0,0,1
"lincoln",0,0,0,0,0,0,1,"DataOne",1,0,0,1
"line-0001",0,0,0,0,0,0,1,"DataOne",1,0,0,1
"line-0002",0,0,0,0,0,0,1,"DataOne",1,0,0,1
"line-0003",0,0,0,0,0,0,1,"DataOne",1,0,0,1
"line-0004",0,0,0,0,0,0,1,"DataOne",1,0,0,1
"line-0005",0,0,0,0,0,0,1,"DataOne",1,0,0,1
"line name",0,0,0,0,0,0,1,"DataOne",1,0,0,1
"line segment",0,0,0,0,0,0,1,"DataOne",1,0,0,1
"liters/minute",0,0,0,0,0,0,1,"DataOne",1,0,0,1
"liters/second",0,0,0,0,0,0,1,"DataOne",1,0,0,1
"litterfall",0,0,0,0,0,0,1,"DataOne",1,0,0,1
"little quilcene",0,0,0,0,0,0,1,"DataOne",1,0,0,1
"liver sample",0,0,0,0,0,0,1,"DataOne",1,0,0,1
"lj33",0,0,0,0,0,0,1,"DataOne",1,0,0,1
"lkat",0,0,0,0,0,0,1,"DataOne",1,0,0,1
"lm50",0,0,0,0,0,0,1,"DataOne",1,0,0,1
"loblolly pine",0,0,0,0,0,0,1,"DataOne",1,0,0,1
"local time in mdt (hour:minute)",0,0,0,0,0,0,1,"DataOne",1,0,0,1
"log hectares",0,0,0,0,0,0,1,"DataOne",1,0,0,1
"log of cubic meters",0,0,0,0,0,0,1,"DataOne",1,0,0,1
"log of cubic meters per second",0,0,0,0,0,0,1,"DataOne",1,0,0,1
"log of days",0,0,0,0,0,0,1,"DataOne",1,0,0,1
"log of kilograms per year",0,0,0,0,0,0,1,"DataOne",1,0,0,1
"log of meters",0,0,0,0,0,0,1,"DataOne",1,0,0,1
"log10 of kilopascals",0,0,0,0,0,0,1,"DataOne",1,0,0,1
"loi",0,0,0,0,0,0,1,"DataOne",1,0,0,1
"loi_pct_gv",0,0,0,0,0,0,1,"DataOne",1,0,0,1
"long bay",0,0,0,0,0,0,1,"DataOne",1,0,0,1
"longnose dace",0,0,0,0,0,0,1,"DataOne",1,0,0,1
"low-medium",0,0,0,0,0,0,1,"DataOne",1,0,0,1
"low heat load",0,0,0,0,0,0,1,"DataOne",1,0,0,1
"lowbkstr",0,0,0,0,0,0,1,"DataOne",1,0,0,1
"lowduneforedune",0,0,0,0,0,0,1,"DataOne",1,0,0,1
"lower 95% mean",0,0,0,0,0,0,1,"DataOne",1,0,0,1
"lower devonian",0,0,0,0,0,0,1,"DataOne",1,0,0,1
"lower mississippian",0,0,0,0,0,0,1,"DataOne",1,0,0,1
"lowflow",0,0,0,0,0,0,1,"DataOne",1,0,0,1
"loyalhanna limestone member",0,0,0,0,0,0,1,"DataOne",1,0,0,1
"ls",0,0,0,0,0,0,1,"DataOne",1,0,0,1
"lsu",0,0,0,0,0,0,1,"DataOne",1,0,0,1
"lsumz",0,0,0,0,0,0,1,"DataOne",1,0,0,1
"ltdu",0,0,0,0,0,0,1,"DataOne",1,0,0,1
"lu",0,0,0,0,0,0,1,"DataOne",1,0,0,1
"lu_ppm_ms_st",0,0,0,0,0,0,1,"DataOne",1,0,0,1
"lu_ppm_na_lc",0,0,0,0,0,0,1,"DataOne",1,0,0,1
"lu_ppm_na_sc",0,0,0,0,0,0,1,"DataOne",1,0,0,1
"lulu",0,0,0,0,0,0,1,"DataOne",1,0,0,1
"luxilis cornutus",0,0,0,0,0,0,1,"DataOne",1,0,0,1
"lx",0,0,0,0,0,0,1,"DataOne",1,0,0,1
"lx58",0,0,0,0,0,0,1,"DataOne",1,0,0,1
"lymnaeidae",0,0,0,0,0,0,1,"DataOne",1,0,0,1
"lynu",0,0,0,0,0,0,1,"DataOne",1,0,0,1
"m bothner",0,0,0,0,0,0,1,"DataOne",1,0,0,1
"m tenbrink",0,0,0,0,0,0,1,"DataOne",1,0,0,1
"m/f",0,0,0,0,0,0,1,"DataOne",1,0,0,1
"m3/hr",0,0,0,0,0,0,1,"DataOne",1,0,0,1
"m3/second",0,0,0,0,0,0,1,"DataOne",1,0,0,1
"ma",0,0,0,0,0,0,1,"DataOne",1,0,0,1
"ma",0,0,0,0,0,0,1,"DataOne",1,0,0,1
"mackenzie river valley",0,0,0,0,0,0,1,"DataOne",1,0,0,1
"macrozooplankton",0,0,0,0,0,0,1,"DataOne",1,0,0,1
"macv",0,0,0,0,0,0,1,"DataOne",1,0,0,1
"mafic dikes",0,0,0,0,0,0,1,"DataOne",1,0,0,1
"mag nail",0,0,0,0,0,0,1,"DataOne",1,0,0,1
"mahantango formation",0,0,0,0,0,0,1,"DataOne",1,0,0,1
"male",0,0,0,0,0,0,1,"DataOne",1,0,0,1
"male",0,0,0,0,0,0,1,"DataOne",1,0,0,1
"mallotus villosus",0,0,0,0,0,0,1,"DataOne",1,0,0,1
"mammal",0,0,0,0,0,0,1,"DataOne",1,0,0,1
"mamu",0,0,0,0,0,0,1,"DataOne",1,0,0,1
"manheim",0,0,0,0,0,0,1,"DataOne",1,0,0,1
"manual entry",0,0,0,0,0,0,1,"DataOne",1,0,0,1
"maple",0,0,0,0,0,0,1,"DataOne",1,0,0,1
"marblemount hatchery, wa",0,0,0,0,0,0,1,"DataOne",1,0,0,1
"marcellus shale",0,0,0,0,0,0,1,"DataOne",1,0,0,1
"marcus hanna",0,0,0,0,0,0,1,"DataOne",1,0,0,1
"margined madtom",0,0,0,0,0,0,1,"DataOne",1,0,0,1
"marine",0,0,0,0,0,0,1,"DataOne",1,0,0,1
"marine operations facility: mof",0,0,0,0,0,0,1,"DataOne",1,0,0,1
"marine09.14c",0,0,0,0,0,0,1,"DataOne",1,0,0,1
"marion dufrense",0,0,0,0,0,0,1,"DataOne",1,0,0,1
"marsh",0,0,0,0,0,0,1,"DataOne",1,0,0,1
"marsh",0,0,0,0,0,0,1,"DataOne",1,0,0,1
"marsh deposit",0,0,0,0,0,0,1,"DataOne",1,0,0,1
"martinsburg formation",0,0,0,0,0,0,1,"DataOne",1,0,0,1
"maryland",0,0,0,0,0,0,1,"DataOne",1,0,0,1
"mass bay",0,0,0,0,0,0,1,"DataOne",1,0,0,1
"mass ratio",0,0,0,0,0,0,1,"DataOne",1,0,0,1
"maurer observed",0,0,0,0,0,0,1,"DataOne",1,0,0,1
"max fluvial occupation, exit and paradise creek",0,0,0,0,0,0,1,"DataOne",1,0,0,1
"maxbh",0,0,0,0,0,0,1,"DataOne",1,0,0,1
"may",0,0,0,0,0,0,1,"DataOne",1,0,0,1
"maybe",0,0,0,0,0,0,1,"DataOne",1,0,0,1
"mcarthur",0,0,0,0,0,0,1,"DataOne",1,0,0,1
"mckenzie formation",0,0,0,0,0,0,1,"DataOne",1,0,0,1
"mcz",0,0,0,0,0,0,1,"DataOne",1,0,0,1
"meadows",0,0,0,0,0,0,1,"DataOne",1,0,0,1
"mean",0,0,0,0,0,0,1,"DataOne",1,0,0,1
"med",0,0,0,0,0,0,1,"DataOne",1,0,0,1
"medium",0,0,0,0,0,0,1,"DataOne",1,0,0,1
"medium gravel",0,0,0,0,0,0,1,"DataOne",1,0,0,1
"medium sand",0,0,0,0,0,0,1,"DataOne",1,0,0,1
"medium sand",0,0,0,0,0,0,1,"DataOne",1,0,0,1
"medium sand and gravel",0,0,0,0,0,0,1,"DataOne",1,0,0,1
"megan miller",0,0,0,0,0,0,1,"DataOne",1,0,0,1
"megaripples and ripples",0,0,0,0,0,0,1,"DataOne",1,0,0,1
"meisburger1976",0,0,0,0,0,0,1,"DataOne",1,0,0,1
"mer-11",0,0,0,0,0,0,1,"DataOne",1,0,0,1
"merging",0,0,0,0,0,0,1,"DataOne",1,0,0,1
"metal scoop",0,0,0,0,0,0,1,"DataOne",1,0,0,1
"meters below mllw",0,0,0,0,0,0,1,"DataOne",1,0,0,1
"meters below sea level",0,0,0,0,0,0,1,"DataOne",1,0,0,1
"meters relative to international great lakes datum, 1985 (igld 85)",0,0,0,0,0,0,1,"DataOne",1,0,0,1
"meters/year",0,0,0,0,0,0,1,"DataOne",1,0,0,1
"meters2",0,0,0,0,0,0,1,"DataOne",1,0,0,1
"mg co2/g toc",0,0,0,0,0,0,1,"DataOne",1,0,0,1
"mg hc/mg co2",0,0,0,0,0,0,1,"DataOne",1,0,0,1
"mg l-1",0,0,0,0,0,0,1,"DataOne",1,0,0,1
"mg per g dry soil",0,0,0,0,0,0,1,"DataOne",1,0,0,1
"mg per liter",0,0,0,0,0,0,1,"DataOne",1,0,0,1
"mg/dm3",0,0,0,0,0,0,1,"DataOne",1,0,0,1
"mg/m3 chl-a (defined by the factory calibration from seabird, the company that manufactured the ctd).",0,0,0,0,0,0,1,"DataOne",1,0,0,1
"mg_pct_aes_st",0,0,0,0,0,0,1,"DataOne",1,0,0,1
"mg_pct_es_sq",0,0,0,0,0,0,1,"DataOne",1,0,0,1
"mg_pct_wdx_fuse",0,0,0,0,0,0,1,"DataOne",1,0,0,1
"mgo",0,0,0,0,0,0,1,"DataOne",1,0,0,1
"mgo_pct_wdx_fuse",0,0,0,0,0,0,1,"DataOne",1,0,0,1
"micro-grams per milliliter",0,0,0,0,0,0,1,"DataOne",1,0,0,1
"micro moles",0,0,0,0,0,0,1,"DataOne",1,0,0,1
"microatmospheres (microatm)",0,0,0,0,0,0,1,"DataOne",1,0,0,1
"microeinsteins",0,0,0,0,0,0,1,"DataOne",1,0,0,1
"microg/microl",0,0,0,0,0,0,1,"DataOne",1,0,0,1
"microgram per cubic meter",0,0,0,0,0,0,1,"DataOne",1,0,0,1
"microgram per kilogram",0,0,0,0,0,0,1,"DataOne",1,0,0,1
"microgram per l",0,0,0,0,0,0,1,"DataOne",1,0,0,1
"microgram per liter",0,0,0,0,0,0,1,"DataOne",1,0,0,1
"micrograms per g dry litter",0,0,0,0,0,0,1,"DataOne",1,0,0,1
"micrograms per g dry soil",0,0,0,0,0,0,1,"DataOne",1,0,0,1
"micrograms per g dry soil per day",0,0,0,0,0,0,1,"DataOne",1,0,0,1
"micrograms/l",0,0,0,0,0,0,1,"DataOne",1,0,0,1
"microgramspersquaremeterperday",0,0,0,0,0,0,1,"DataOne",1,0,0,1
"micromole methane per square meter per day",0,0,0,0,0,0,1,"DataOne",1,0,0,1
"micromolepermetersquarepersecond",0,0,0,0,0,0,1,"DataOne",1,0,0,1
"micromoles of co2 per meter squared per second",0,0,0,0,0,0,1,"DataOne",1,0,0,1
"micromoles per kilogram of seawater (umol/kg)",0,0,0,0,0,0,1,"DataOne",1,0,0,1
"microns",0,0,0,0,0,0,1,"DataOne",1,0,0,1
"microperus salmoides",0,0,0,0,0,0,1,"DataOne",1,0,0,1
"micropterus dolomieu",0,0,0,0,0,0,1,"DataOne",1,0,0,1
"microseaboss (a.k.a. seabosspro, a.k.a. goproseaboss)",0,0,0,0,0,0,1,"DataOne",1,0,0,1
"microseimens",0,0,0,0,0,0,1,"DataOne",1,0,0,1
"microsiemens per centimeter (us/cm)",0,0,0,0,0,0,1,"DataOne",1,0,0,1
"microzooplankton",0,0,0,0,0,0,1,"DataOne",1,0,0,1
"middle devonian",0,0,0,0,0,0,1,"DataOne",1,0,0,1
"middle ordovician",0,0,0,0,0,0,1,"DataOne",1,0,0,1
"middle/upper devonian",0,0,0,0,0,0,1,"DataOne",1,0,0,1
"middleton island, alaska",0,0,0,0,0,0,1,"DataOne",1,0,0,1
"miillion cubic meters",0,0,0,0,0,0,1,"DataOne",1,0,0,1
"miles",0,0,0,0,0,0,1,"DataOne",1,0,0,1
"miles per hour",0,0,0,0,0,0,1,"DataOne",1,0,0,1
"miles per hour (mph)",0,0,0,0,0,0,1,"DataOne",1,0,0,1
"miligrampermililiter",0,0,0,0,0,0,1,"DataOne",1,0,0,1
"miligramspersquaremeterperday",0,0,0,0,0,0,1,"DataOne",1,0,0,1
"milivolts",0,0,0,0,0,0,1,"DataOne",1,0,0,1
"mill river (nh)",0,0,0,0,0,0,1,"DataOne",1,0,0,1
"mill site",0,0,0,0,0,0,1,"DataOne",1,0,0,1
"millboro shale",0,0,0,0,0,0,1,"DataOne",1,0,0,1
"millgrams of hydrocarbon per gram of rock",0,0,0,0,0,0,1,"DataOne",1,0,0,1
"milliamps",0,0,0,0,0,0,1,"DataOne",1,0,0,1
"milligram of methane per square meter per day",0,0,0,0,0,0,1,"DataOne",1,0,0,1
"milligram per liter",0,0,0,0,0,0,1,"DataOne",1,0,0,1
"milligrams / liter (mg/l)",0,0,0,0,0,0,1,"DataOne",1,0,0,1
"milligrams carbon per liter (mg c/l)",0,0,0,0,0,0,1,"DataOne",1,0,0,1
"milligrams of [s1] hydrocarbons milligrams of [s1 + s2] hydrocarbons",0,0,0,0,0,0,1,"DataOne",1,0,0,1
"milligrams of carbon dioxide [100 x s3] per gram of total organic carbon",0,0,0,0,0,0,1,"DataOne",1,0,0,1
"milligrams of hydrocarbons [100 x s2] per gram of total organic carbon",0,0,0,0,0,0,1,"DataOne",1,0,0,1
"milligrams per gram of oil (mg/g of oil)",0,0,0,0,0,0,1,"DataOne",1,0,0,1
"milligrams per kilogram, or equivalently parts per million",0,0,0,0,0,0,1,"DataOne",1,0,0,1
"milligrams per liter (mg/l), < indicates value was less than the laboratory reporting level",0,0,0,0,0,0,1,"DataOne",1,0,0,1
"milligrams per liter (mg/l), value of -9999 denotes data not collected",0,0,0,0,0,0,1,"DataOne",1,0,0,1
"milligrams per liter carbon",0,0,0,0,0,0,1,"DataOne",1,0,0,1
"milligrams per milliliter",0,0,0,0,0,0,1,"DataOne",1,0,0,1
"milligrams/per gram of oil (mg/g oil)",0,0,0,0,0,0,1,"DataOne",1,0,0,1
"milligramsmethanepersquaremeterperday",0,0,0,0,0,0,1,"DataOne",1,0,0,1
"milligramspergrampermole",0,0,0,0,0,0,1,"DataOne",1,0,0,1
"milliliterpersecond",0,0,0,0,0,0,1,"DataOne",1,0,0,1
"millimeter",0,0,0,0,0,0,1,"DataOne",1,0,0,1
"millimeterpercentimetersquared",0,0,0,0,0,0,1,"DataOne",1,0,0,1
"millimeterpercentimetersquaredperday",0,0,0,0,0,0,1,"DataOne",1,0,0,1
"millimole of carbon dioxide per square meter per day, using an assumed carbon dioxide concentration in air of 407 parts per million",0,0,0,0,0,0,1,"DataOne",1,0,0,1
"millimoles of carbon dioxide per square meter per day, using corrected carbon dioxide concentration value in air; no data value 999 corresponds to intervals when air co2 values were set to 999 because they were out of range (e.g., in the smokestack emissions)",0,0,0,0,0,0,1,"DataOne",1,0,0,1
"millimoles per square meter per second",0,0,0,0,0,0,1,"DataOne",1,0,0,1
"millimolespermetersquarepersecond",0,0,0,0,0,0,1,"DataOne",1,0,0,1
"million acre feet",0,0,0,0,0,0,1,"DataOne",1,0,0,1
"million barrels / km2",0,0,0,0,0,0,1,"DataOne",1,0,0,1
"million barrels of ngl / km2",0,0,0,0,0,0,1,"DataOne",1,0,0,1
"million pounds",0,0,0,0,0,0,1,"DataOne",1,0,0,1
"milliseconds",0,0,0,0,0,0,1,"DataOne",1,0,0,1
"milliwattpermetersquaredpersteradianpersecond",0,0,0,0,0,0,1,"DataOne",1,0,0,1
"mind the gap",0,0,0,0,0,0,1,"DataOne",1,0,0,1
"mine dump",0,0,0,0,0,0,1,"DataOne",1,0,0,1
"mine shaft",0,0,0,0,0,0,1,"DataOne",1,0,0,1
"mini seaboss w/ 0.1 sq m van veen grab",0,0,0,0,0,0,1,"DataOne",1,0,0,1
"minnow trap",0,0,0,0,0,0,1,"DataOne",1,0,0,1
"minute of the day",0,0,0,0,0,0,1,"DataOne",1,0,0,1
"minutes (0 - 60)",0,0,0,0,0,0,1,"DataOne",1,0,0,1
"minutes (0 - 60)",0,0,0,0,0,0,1,"DataOne",1,0,0,1
"miroc mc1",0,0,0,0,0,0,1,"DataOne",1,0,0,1
"missing",0,0,0,0,0,0,1,"DataOne",1,0,0,1
"mississippian",0,0,0,0,0,0,1,"DataOne",1,0,0,1
"mixed",0,0,0,0,0,0,1,"DataOne",1,0,0,1
"mixed",0,0,0,0,0,0,1,"DataOne",1,0,0,1
"mkj101",0,0,0,0,0,0,1,"DataOne",1,0,0,1
"mm w.e.",0,0,0,0,0,0,1,"DataOne",1,0,0,1
"mm, ek",0,0,0,0,0,0,1,"DataOne",1,0,0,1
"mm, km",0,0,0,0,0,0,1,"DataOne",1,0,0,1
"mm/dd/yyyy where dd, mm, yyyy are digits representing day, month, year, and the first digit of single-valued days and months are not written",0,0,0,0,0,0,1,"DataOne",1,0,0,1
"mmd reporting",0,0,0,0,0,0,1,"DataOne",1,0,0,1
"mmhg (torr)",0,0,0,0,0,0,1,"DataOne",1,0,0,1
"mmole/m2/s",0,0,0,0,0,0,1,"DataOne",1,0,0,1
"mn",0,0,0,0,0,0,1,"DataOne",1,0,0,1
"mn_pct_aes_st",0,0,0,0,0,0,1,"DataOne",1,0,0,1
"mn_pct_es_sq",0,0,0,0,0,0,1,"DataOne",1,0,0,1
"mn_pct_wdx_fuse",0,0,0,0,0,0,1,"DataOne",1,0,0,1
"mno",0,0,0,0,0,0,1,"DataOne",1,0,0,1
"mno_pct_wdx_fuse",0,0,0,0,0,0,1,"DataOne",1,0,0,1
"mo_ppm_aes_az_p",0,0,0,0,0,0,1,"DataOne",1,0,0,1
"mo_ppm_es_sq",0,0,0,0,0,0,1,"DataOne",1,0,0,1
"mo_ppm_ms_st",0,0,0,0,0,0,1,"DataOne",1,0,0,1
"mobile and immobile sediment",0,0,0,0,0,0,1,"DataOne",1,0,0,1
"mobile sediment",0,0,0,0,0,0,1,"DataOne",1,0,0,1
"mod",0,0,0,0,0,0,1,"DataOne",1,0,0,1
"moderate high heat load",0,0,0,0,0,0,1,"DataOne",1,0,0,1
"moderate low heat load",0,0,0,0,0,0,1,"DataOne",1,0,0,1
"modes",0,0,0,0,0,0,1,"DataOne",1,0,0,1
"moist",0,0,0,0,0,0,1,"DataOne",1,0,0,1
"mol_perdm3",0,0,0,0,0,0,1,"DataOne",1,0,0,1
"molesperhour",0,0,0,0,0,0,1,"DataOne",1,0,0,1
"molt",0,0,0,0,0,0,1,"DataOne",1,0,0,1
"molted skin",0,0,0,0,0,0,1,"DataOne",1,0,0,1
"monache creek",0,0,0,0,0,0,1,"DataOne",1,0,0,1
"monache mountain",0,0,0,0,0,0,1,"DataOne",1,0,0,1
"month (mmm) and year (yy)",0,0,0,0,0,0,1,"DataOne",1,0,0,1
"monument",0,0,0,0,0,0,1,"DataOne",1,0,0,1
"moore1963",0,0,0,0,0,0,1,"DataOne",1,0,0,1
"morainal-alluvial",0,0,0,0,0,0,1,"DataOne",1,0,0,1
"moraine",0,0,0,0,0,0,1,"DataOne",1,0,0,1
"morone saxitilis",0,0,0,0,0,0,1,"DataOne",1,0,0,1
"morris peak",0,0,0,0,0,0,1,"DataOne",1,0,0,1
"mort",0,0,0,0,0,0,1,"DataOne",1,0,0,1
"mottled",0,0,0,0,0,0,1,"DataOne",1,0,0,1
"mottled",0,0,0,0,0,0,1,"DataOne",1,0,0,1
"mottled bs",0,0,0,0,0,0,1,"DataOne",1,0,0,1
"mottled sculpin",0,0,0,0,0,0,1,"DataOne",1,0,0,1
"moving ice",0,0,0,0,0,0,1,"DataOne",1,0,0,1
"moxa",0,0,0,0,0,0,1,"DataOne",1,0,0,1
"ms_ar_p",0,0,0,0,0,0,1,"DataOne",1,0,0,1
"ms_fuse",0,0,0,0,0,0,1,"DataOne",1,0,0,1
"ms_hf",0,0,0,0,0,0,1,"DataOne",1,0,0,1
"ms_hf_ree",0,0,0,0,0,0,1,"DataOne",1,0,0,1
"ms_hno3_p",0,0,0,0,0,0,1,"DataOne",1,0,0,1
"ms_id",0,0,0,0,0,0,1,"DataOne",1,0,0,1
"ms_is",0,0,0,0,0,0,1,"DataOne",1,0,0,1
"ms_ss",0,0,0,0,0,0,1,"DataOne",1,0,0,1
"mse",0,0,0,0,0,0,1,"DataOne",1,0,0,1
"msel",0,0,0,0,0,0,1,"DataOne",1,0,0,1
"msmb-09",0,0,0,0,0,0,1,"DataOne",1,0,0,1
"msmb-24",0,0,0,0,0,0,1,"DataOne",1,0,0,1
"msmb-47",0,0,0,0,0,0,1,"DataOne",1,0,0,1
"mspr-08",0,0,0,0,0,0,1,"DataOne",1,0,0,1
"mssc-04",0,0,0,0,0,0,1,"DataOne",1,0,0,1
"mssc-06",0,0,0,0,0,0,1,"DataOne",1,0,0,1
"mssv-03",0,0,0,0,0,0,1,"DataOne",1,0,0,1
"mssv-05",0,0,0,0,0,0,1,"DataOne",1,0,0,1
"mssv-19",0,0,0,0,0,0,1,"DataOne",1,0,0,1
"mud_peat",0,0,0,0,0,0,1,"DataOne",1,0,0,1
"muddy sand",0,0,0,0,0,0,1,"DataOne",1,0,0,1
"mulb",0,0,0,0,0,0,1,"DataOne",1,0,0,1
"mulr",0,0,0,0,0,0,1,"DataOne",1,0,0,1
"multi-acid",0,0,0,0,0,0,1,"DataOne",1,0,0,1
"multiplex",0,0,0,0,0,0,1,"DataOne",1,0,0,1
"murrells inlet",0,0,0,0,0,0,1,"DataOne",1,0,0,1
"mus/cm",0,0,0,0,0,0,1,"DataOne",1,0,0,1
"muscidae",0,0,0,0,0,0,1,"DataOne",1,0,0,1
"muscle sample",0,0,0,0,0,0,1,"DataOne",1,0,0,1
"muscle/lpb",0,0,0,0,0,0,1,"DataOne",1,0,0,1
"mussel",0,0,0,0,0,0,1,"DataOne",1,0,0,1
"mvz",0,0,0,0,0,0,1,"DataOne",1,0,0,1
"mvz salt",0,0,0,0,0,0,1,"DataOne",1,0,0,1
"mw",0,0,0,0,0,0,1,"DataOne",1,0,0,1
"mw, ek",0,0,0,0,0,0,1,"DataOne",1,0,0,1
"mw, km, ek",0,0,0,0,0,0,1,"DataOne",1,0,0,1
"mylu",0,0,0,0,0,0,1,"DataOne",1,0,0,1
"mysid",0,0,0,0,0,0,1,"DataOne",1,0,0,1
"myso",0,0,0,0,0,0,1,"DataOne",1,0,0,1
"mytilus trossulus",0,0,0,0,0,0,1,"DataOne",1,0,0,1
"n america",0,0,0,0,0,0,1,"DataOne",1,0,0,1
"n cm-2",0,0,0,0,0,0,1,"DataOne",1,0,0,1
"n mm-1",0,0,0,0,0,0,1,"DataOne",1,0,0,1
"n/ha",0,0,0,0,0,0,1,"DataOne",1,0,0,1
"n80_1_1minnav_sort.shp",0,0,0,0,0,0,1,"DataOne",1,0,0,1
"na",0,0,0,0,0,0,1,"DataOne",1,0,0,1
"na_oe",0,0,0,0,0,0,1,"DataOne",1,0,0,1
"na_pct_es_sq",0,0,0,0,0,0,1,"DataOne",1,0,0,1
"na_pct_na_lc",0,0,0,0,0,0,1,"DataOne",1,0,0,1
"na_pct_na_sc",0,0,0,0,0,0,1,"DataOne",1,0,0,1
"na_pct_wdx_fuse",0,0,0,0,0,0,1,"DataOne",1,0,0,1
"na_pg",0,0,0,0,0,0,1,"DataOne",1,0,0,1
"na_rc",0,0,0,0,0,0,1,"DataOne",1,0,0,1
"na_ree",0,0,0,0,0,0,1,"DataOne",1,0,0,1
"na2o",0,0,0,0,0,0,1,"DataOne",1,0,0,1
"na2o_pct_wdx_fuse",0,0,0,0,0,0,1,"DataOne",1,0,0,1
"na2o2 sinter",0,0,0,0,0,0,1,"DataOne",1,0,0,1
"named on 19xx map.",0,0,0,0,0,0,1,"DataOne",1,0,0,1
"nancy foster",0,0,0,0,0,0,1,"DataOne",1,0,0,1
"nano lna",0,0,0,0,0,0,1,"DataOne",1,0,0,1
"nano zen",0,0,0,0,0,0,1,"DataOne",1,0,0,1
"nanogram per microliter",0,0,0,0,0,0,1,"DataOne",1,0,0,1
"nanograms of dna per microliter (ng/ul)",0,0,0,0,0,0,1,"DataOne",1,0,0,1
"nanograms per microliter",0,0,0,0,0,0,1,"DataOne",1,0,0,1
"nanogramsnitrogenpersquarecentimeterperhour",0,0,0,0,0,0,1,"DataOne",1,0,0,1
"nanomol per mol",0,0,0,0,0,0,1,"DataOne",1,0,0,1
"nanomolar",0,0,0,0,0,0,1,"DataOne",1,0,0,1
"nanomoles per liter",0,0,0,0,0,0,1,"DataOne",1,0,0,1
"nanophyetus salmincola",0,0,0,0,0,0,1,"DataOne",1,0,0,1
"nashua national fish hatchery, nh (stock from penobscot river, me)",0,0,0,0,0,0,1,"DataOne",1,0,0,1
"national forest visit",0,0,0,0,0,0,1,"DataOne",1,0,0,1
"natrix natrix",0,0,0,0,0,0,1,"DataOne",1,0,0,1
"natrix tessellata",0,0,0,0,0,0,1,"DataOne",1,0,0,1
"natural",0,0,0,0,0,0,1,"DataOne",1,0,0,1
"nautical miles per hour (knots)",0,0,0,0,0,0,1,"DataOne",1,0,0,1
"navd29",0,0,0,0,0,0,1,"DataOne",1,0,0,1
"navd88",0,0,0,0,0,0,1,"DataOne",1,0,0,1
"nb",0,0,0,0,0,0,1,"DataOne",1,0,0,1
"nb",0,0,0,0,0,0,1,"DataOne",1,0,0,1
"nb_ppm_edx",0,0,0,0,0,0,1,"DataOne",1,0,0,1
"nb_ppm_es_sq",0,0,0,0,0,0,1,"DataOne",1,0,0,1
"nb_ppm_ms_st",0,0,0,0,0,0,1,"DataOne",1,0,0,1
"ncedc",0,0,0,0,0,0,1,"DataOne",1,0,0,1
"nd",0,0,0,0,0,0,1,"DataOne",1,0,0,1
"nd_ppm_ms_st",0,0,0,0,0,0,1,"DataOne",1,0,0,1
"nd_ppm_ms_st_ree",0,0,0,0,0,0,1,"DataOne",1,0,0,1
"nd_ppm_na_lc",0,0,0,0,0,0,1,"DataOne",1,0,0,1
"nd_ppm_na_sc",0,0,0,0,0,0,1,"DataOne",1,0,0,1
"ne _corner_flagpole_pad",0,0,0,0,0,0,1,"DataOne",1,0,0,1
"near",0,0,0,0,0,0,1,"DataOne",1,0,0,1
"neecho",0,0,0,0,0,0,1,"DataOne",1,0,0,1
"needmore shale",0,0,0,0,0,0,1,"DataOne",1,0,0,1
"neg",0,0,0,0,0,0,1,"DataOne",1,0,0,1
"neg",0,0,0,0,0,0,1,"DataOne",1,0,0,1
"negative for visible n. salminocola",0,0,0,0,0,0,1,"DataOne",1,0,0,1
"nematoda",0,0,0,0,0,0,1,"DataOne",1,0,0,1
"nematomorpha",0,0,0,0,0,0,1,"DataOne",1,0,0,1
"nemouridae",0,0,0,0,0,0,1,"DataOne",1,0,0,1
"neomysis rayii",0,0,0,0,0,0,1,"DataOne",1,0,0,1
"nephelometric turbidity ratio unit (ntru)",0,0,0,0,0,0,1,"DataOne",1,0,0,1
"neptune",0,0,0,0,0,0,1,"DataOne",1,0,0,1
"nest",0,0,0,0,0,0,1,"DataOne",1,0,0,1
"neversink river (ny)",0,0,0,0,0,0,1,"DataOne",1,0,0,1
"new creek limestone",0,0,0,0,0,0,1,"DataOne",1,0,0,1
"new market limestone",0,0,0,0,0,0,1,"DataOne",1,0,0,1
"new york",0,0,0,0,0,0,1,"DataOne",1,0,0,1
"ng/ul",0,0,0,0,0,0,1,"DataOne",1,0,0,1
"ngvd29",0,0,0,0,0,0,1,"DataOne",1,0,0,1
"ni",0,0,0,0,0,0,1,"DataOne",1,0,0,1
"ni_ppm_aes_st",0,0,0,0,0,0,1,"DataOne",1,0,0,1
"ni_ppm_edx",0,0,0,0,0,0,1,"DataOne",1,0,0,1
"ni_ppm_es_sq",0,0,0,0,0,0,1,"DataOne",1,0,0,1
"ni_ppm_na_lc",0,0,0,0,0,0,1,"DataOne",1,0,0,1
"ni_ppm_na_sc",0,0,0,0,0,0,1,"DataOne",1,0,0,1
"nis fire assay",0,0,0,0,0,0,1,"DataOne",1,0,0,1
"niskin bottle",0,0,0,0,0,0,1,"DataOne",1,0,0,1
"nisqually",0,0,0,0,0,0,1,"DataOne",1,0,0,1
"nisqually river, wa",0,0,0,0,0,0,1,"DataOne",1,0,0,1
"nitrate concentrations, micromolar (um)",0,0,0,0,0,0,1,"DataOne",1,0,0,1
"nitrate, 00630",0,0,0,0,0,0,1,"DataOne",1,0,0,1
"nitrate, 00631",0,0,0,0,0,0,1,"DataOne",1,0,0,1
"nitrite concentrations, micromolar (um)",0,0,0,0,0,0,1,"DataOne",1,0,0,1
"nlonsu",0,0,0,0,0,0,1,"DataOne",1,0,0,1
"nmol totfe/m2/d",0,0,0,0,0,0,1,"DataOne",1,0,0,1
"nmol/g dry sediment weight",0,0,0,0,0,0,1,"DataOne",1,0,0,1
"nmole fe per kilogram of seawater",0,0,0,0,0,0,1,"DataOne",1,0,0,1
"no-bent",0,0,0,0,0,0,1,"DataOne",1,0,0,1
"no-no recov",0,0,0,0,0,0,1,"DataOne",1,0,0,1
"no juga spp. observed at the sample site",0,0,0,0,0,0,1,"DataOne",1,0,0,1
"no plague",0,0,0,0,0,0,1,"DataOne",1,0,0,1
"no; date is missing",0,0,0,0,0,0,1,"DataOne",1,0,0,1
"no; date is not summer",0,0,0,0,0,0,1,"DataOne",1,0,0,1
"no; inaccurate data because of canal",0,0,0,0,0,0,1,"DataOne",1,0,0,1
"no; located below nhd+ sink",0,0,0,0,0,0,1,"DataOne",1,0,0,1
"no; located on canal",0,0,0,0,0,0,1,"DataOne",1,0,0,1
"no; missing data upstream",0,0,0,0,0,0,1,"DataOne",1,0,0,1
"no; outside 2004-2016",0,0,0,0,0,0,1,"DataOne",1,0,0,1
"no; perennial observation before july",0,0,0,0,0,0,1,"DataOne",1,0,0,1
"no; too small of basin",0,0,0,0,0,0,1,"DataOne",1,0,0,1
"noaa awos",0,0,0,0,0,0,1,"DataOne",1,0,0,1
"noha",0,0,0,0,0,0,1,"DataOne",1,0,0,1
"non-coking bituminuos coal",0,0,0,0,0,0,1,"DataOne",1,0,0,1
"non-erodible shoreline",0,0,0,0,0,0,1,"DataOne",1,0,0,1
"non-fluvial",0,0,0,0,0,0,1,"DataOne",1,0,0,1
"non-perennial",0,0,0,0,0,0,1,"DataOne",1,0,0,1
"noname",0,0,0,0,0,0,1,"DataOne",1,0,0,1
"nooksack",0,0,0,0,0,0,1,"DataOne",1,0,0,1
"nordland, wa",0,0,0,0,0,0,1,"DataOne",1,0,0,1
"northeast monitoring program",0,0,0,0,0,0,1,"DataOne",1,0,0,1
"northern & central ruderal wet meadow & marsh group",0,0,0,0,0,0,1,"DataOne",1,0,0,1
"northern alberta",0,0,0,0,0,0,1,"DataOne",1,0,0,1
"northern hog sucker",0,0,0,0,0,0,1,"DataOne",1,0,0,1
"northwest territories",0,0,0,0,0,0,1,"DataOne",1,0,0,1
"nos hydrographic database",0,0,0,0,0,0,1,"DataOne",1,0,0,1
"nose to nose",0,0,0,0,0,0,1,"DataOne",1,0,0,1
"not detected",0,0,0,0,0,0,1,"DataOne",1,0,0,1
"not recaptured",0,0,0,0,0,0,1,"DataOne",1,0,0,1
"not screened",0,0,0,0,0,0,1,"DataOne",1,0,0,1
"notemigonus crysoleucas",0,0,0,0,0,0,1,"DataOne",1,0,0,1
"noturus insignis",0,0,0,0,0,0,1,"DataOne",1,0,0,1
"nr",0,0,0,0,0,0,1,"DataOne",1,0,0,1
"nse",0,0,0,0,0,0,1,"DataOne",1,0,0,1
"nsel",0,0,0,0,0,0,1,"DataOne",1,0,0,1
"nsfvol-09",0,0,0,0,0,0,1,"DataOne",1,0,0,1
"nsfvol-19",0,0,0,0,0,0,1,"DataOne",1,0,0,1
"nsfvp-01",0,0,0,0,0,0,1,"DataOne",1,0,0,1
"nsfvp-06",0,0,0,0,0,0,1,"DataOne",1,0,0,1
"nsfvp-07",0,0,0,0,0,0,1,"DataOne",1,0,0,1
"nsfwg-02",0,0,0,0,0,0,1,"DataOne",1,0,0,1
"nsfwg-07",0,0,0,0,0,0,1,"DataOne",1,0,0,1
"nsfwg-11",0,0,0,0,0,0,1,"DataOne",1,0,0,1
"nsj-qpc-04",0,0,0,0,0,0,1,"DataOne",1,0,0,1
"nsj-qpc-07",0,0,0,0,0,0,1,"DataOne",1,0,0,1
"number of alleles",0,0,0,0,0,0,1,"DataOne",1,0,0,1
"number of animals",0,0,0,0,0,0,1,"DataOne",1,0,0,1
"number of individuals per g afdm",0,0,0,0,0,0,1,"DataOne",1,0,0,1
"number of individuals per g dry soil",0,0,0,0,0,0,1,"DataOne",1,0,0,1
"number of mines",0,0,0,0,0,0,1,"DataOne",1,0,0,1
"number of observations",0,0,0,0,0,0,1,"DataOne",1,0,0,1
"number of people per county",0,0,0,0,0,0,1,"DataOne",1,0,0,1
"number of taxa",0,0,0,0,0,0,1,"DataOne",1,0,0,1
"number of taxa observed",0,0,0,0,0,0,1,"DataOne",1,0,0,1
"numberper200sweeps",0,0,0,0,0,0,1,"DataOne",1,0,0,1
"numberperkilometer",0,0,0,0,0,0,1,"DataOne",1,0,0,1
"numbers",0,0,0,0,0,0,1,"DataOne",1,0,0,1
"numbers representing normalized intensity values",0,0,0,0,0,0,1,"DataOne",1,0,0,1
"numbers representing standard deviation of bathymetric elevation values",0,0,0,0,0,0,1,"DataOne",1,0,0,1
"nunavut",0,0,0,0,0,0,1,"DataOne",1,0,0,1
"nwfwmd site_id  listed in otid",0,0,0,0,0,0,1,"DataOne",1,0,0,1
"nwfwmd_may2010_data",0,0,0,0,0,0,1,"DataOne",1,0,0,1
"nwlw",0,0,0,0,0,0,1,"DataOne",1,0,0,1
"nx",0,0,0,0,0,0,1,"DataOne",1,0,0,1
"o/d",0,0,0,0,0,0,1,"DataOne",1,0,0,1
"oak",0,0,0,0,0,0,1,"DataOne",1,0,0,1
"obstruction or wreck",0,0,0,0,0,0,1,"DataOne",1,0,0,1
"oceanus",0,0,0,0,0,0,1,"DataOne",1,0,0,1
"oct",0,0,0,0,0,0,1,"DataOne",1,0,0,1
"odfw",0,0,0,0,0,0,1,"DataOne",1,0,0,1
"off.shelf",0,0,0,0,0,0,1,"DataOne",1,0,0,1
"offshore",0,0,0,0,0,0,1,"DataOne",1,0,0,1
"ohio",0,0,0,0,0,0,1,"DataOne",1,0,0,1
"ohio shale",0,0,0,0,0,0,1,"DataOne",1,0,0,1
"ohm-m,  ohm-meters",0,0,0,0,0,0,1,"DataOne",1,0,0,1
"ohm-m, ohm meter",0,0,0,0,0,0,1,"DataOne",1,0,0,1
"ohm-m, ohm meters",0,0,0,0,0,0,1,"DataOne",1,0,0,1
"ohm-m, ohm meters",0,0,0,0,0,0,1,"DataOne",1,0,0,1
"ohm-m, ohm per meter",0,0,0,0,0,0,1,"DataOne",1,0,0,1
"ohmmeter",0,0,0,0,0,0,1,"DataOne",1,0,0,1
"ohms",0,0,0,0,0,0,1,"DataOne",1,0,0,1
"ohms",0,0,0,0,0,0,1,"DataOne",1,0,0,1
"oil/gas",0,0,0,0,0,0,1,"DataOne",1,0,0,1
"olancha peak",0,0,0,0,0,0,1,"DataOne",1,0,0,1
"olentangy shale",0,0,0,0,0,0,1,"DataOne",1,0,0,1
"oligochaeta",0,0,0,0,0,0,1,"DataOne",1,0,0,1
"omnivore",0,0,0,0,0,0,1,"DataOne",1,0,0,1
"on.shelf",0,0,0,0,0,0,1,"DataOne",1,0,0,1
"open native forest (grass/shrub)",0,0,0,0,0,0,1,"DataOne",1,0,0,1
"open pit mine",0,0,0,0,0,0,1,"DataOne",1,0,0,1
"open pit mine or quarry",0,0,0,0,0,0,1,"DataOne",1,0,0,1
"open water",0,0,0,0,0,0,1,"DataOne",1,0,0,1
"open_canopy",0,0,0,0,0,0,1,"DataOne",1,0,0,1
"ordovician",0,0,0,0,0,0,1,"DataOne",1,0,0,1
"ore stockpile/storage",0,0,0,0,0,0,1,"DataOne",1,0,0,1
"orient point",0,0,0,0,0,0,1,"DataOne",1,0,0,1
"oriskany sandstone",0,0,0,0,0,0,1,"DataOne",1,0,0,1
"orthogneiss",0,0,0,0,0,0,1,"DataOne",1,0,0,1
"orthophosphate, 00671",0,0,0,0,0,0,1,"DataOne",1,0,0,1
"ostracoda",0,0,0,0,0,0,1,"DataOne",1,0,0,1
"oth",0,0,0,0,0,0,1,"DataOne",1,0,0,1
"other (oil, drowning, cardiovascular)",0,0,0,0,0,0,1,"DataOne",1,0,0,1
"outcrop",0,0,0,0,0,0,1,"DataOne",1,0,0,1
"outer yukon-kuskokwim delta, alaska",0,0,0,0,0,0,1,"DataOne",1,0,0,1
"outliers",0,0,0,0,0,0,1,"DataOne",1,0,0,1
"outwash plain",0,0,0,0,0,0,1,"DataOne",1,0,0,1
"overcast",0,0,0,0,0,0,1,"DataOne",1,0,0,1
"overton arm",0,0,0,0,0,0,1,"DataOne",1,0,0,1
"owens peak",0,0,0,0,0,0,1,"DataOne",1,0,0,1
"oyster",0,0,0,0,0,0,1,"DataOne",1,0,0,1
"p_pct_aes_st",0,0,0,0,0,0,1,"DataOne",1,0,0,1
"p_pct_es_sq",0,0,0,0,0,0,1,"DataOne",1,0,0,1
"p_pct_wdx_fuse",0,0,0,0,0,0,1,"DataOne",1,0,0,1
"p2o5",0,0,0,0,0,0,1,"DataOne",1,0,0,1
"p2o5_pct_wdx_fuse",0,0,0,0,0,0,1,"DataOne",1,0,0,1
"pa-echdl",0,0,0,0,0,0,1,"DataOne",1,0,0,1
"pa-rscpi",0,0,0,0,0,0,1,"DataOne",1,0,0,1
"pacific",0,0,0,0,0,0,1,"DataOne",1,0,0,1
"paja",0,0,0,0,0,0,1,"DataOne",1,0,0,1
"palmer",0,0,0,0,0,0,1,"DataOne",1,0,0,1
"pan",0,0,0,0,0,0,1,"DataOne",1,0,0,1
"pandalus hypsinotus",0,0,0,0,0,0,1,"DataOne",1,0,0,1
"papa",0,0,0,0,0,0,1,"DataOne",1,0,0,1
"paqu2",0,0,0,0,0,0,1,"DataOne",1,0,0,1
"paradise creek active braid plain",0,0,0,0,0,0,1,"DataOne",1,0,0,1
"paradise creek transitional braid plain",0,0,0,0,0,0,1,"DataOne",1,0,0,1
"parasite",0,0,0,0,0,0,1,"DataOne",1,0,0,1
"partly cloudy",0,0,0,0,0,0,1,"DataOne",1,0,0,1
"parts per million (ppm)",0,0,0,0,0,0,1,"DataOne",1,0,0,1
"parts per million (ppm),< indicates value was less than the laboratory reporting level",0,0,0,0,0,0,1,"DataOne",1,0,0,1
"passeriformes",0,0,0,0,0,0,1,"DataOne",1,0,0,1
"pat",0,0,0,0,0,0,1,"DataOne",1,0,0,1
"pb",0,0,0,0,0,0,1,"DataOne",1,0,0,1
"pb_ppm_aes_az_p",0,0,0,0,0,0,1,"DataOne",1,0,0,1
"pb_ppm_es_sq",0,0,0,0,0,0,1,"DataOne",1,0,0,1
"pb_ppm_ms_st",0,0,0,0,0,0,1,"DataOne",1,0,0,1
"pbo fire assay; icp-ms",0,0,0,0,0,0,1,"DataOne",1,0,0,1
"pc",0,0,0,0,0,0,1,"DataOne",1,0,0,1
"pc1",0,0,0,0,0,0,1,"DataOne",1,0,0,1
"pc2",0,0,0,0,0,0,1,"DataOne",1,0,0,1
"pc3",0,0,0,0,0,0,1,"DataOne",1,0,0,1
"pci/l",0,0,0,0,0,0,1,"DataOne",1,0,0,1
"pcob",0,0,0,0,0,0,1,"DataOne",1,0,0,1
"pct",0,0,0,0,0,0,1,"DataOne",1,0,0,1
"pd",0,0,0,0,0,0,1,"DataOne",1,0,0,1
"pd",0,0,0,0,0,0,1,"DataOne",1,0,0,1
"pd_ppm_fa_ms",0,0,0,0,0,0,1,"DataOne",1,0,0,1
"pealei",0,0,0,0,0,0,1,"DataOne",1,0,0,1
"pelecaniformes",0,0,0,0,0,0,1,"DataOne",1,0,0,1
"penn yan shale member",0,0,0,0,0,0,1,"DataOne",1,0,0,1
"pennsylvania",0,0,0,0,0,0,1,"DataOne",1,0,0,1
"perca flavescens",0,0,0,0,0,0,1,"DataOne",1,0,0,1
"percent (%)",0,0,0,0,0,0,1,"DataOne",1,0,0,1
"percent expressed as a decimal (i.e., 0.7 = 70 percent probability for a given response variable threshold )",0,0,0,0,0,0,1,"DataOne",1,0,0,1
"percent expressed as a decimal (i.e., 0.7 = 70 percent probability of anoxic conditions for a given response variable threshold )",0,0,0,0,0,0,1,"DataOne",1,0,0,1
"percent expressed as a decimal (i.e., 0.7 = 70 percent probability of manganese concentration exceedance for a given response variable threshold )",0,0,0,0,0,0,1,"DataOne",1,0,0,1
"percent of dry mass",0,0,0,0,0,0,1,"DataOne",1,0,0,1
"percent of original",0,0,0,0,0,0,1,"DataOne",1,0,0,1
"percent rise",0,0,0,0,0,0,1,"DataOne",1,0,0,1
"percent, < indicates value was less than the laboratory reporting level",0,0,0,0,0,0,1,"DataOne",1,0,0,1
"percentage of mass lost",0,0,0,0,0,0,1,"DataOne",1,0,0,1
"percentage of saturation",0,0,0,0,0,0,1,"DataOne",1,0,0,1
"percentage of total sample.",0,0,0,0,0,0,1,"DataOne",1,0,0,1
"percina peltata",0,0,0,0,0,0,1,"DataOne",1,0,0,1
"perennial",0,0,0,0,0,0,1,"DataOne",1,0,0,1
"perm",0,0,0,0,0,0,1,"DataOne",1,0,0,1
"persquaremeter",0,0,0,0,0,0,1,"DataOne",1,0,0,1
"pesa",0,0,0,0,0,0,1,"DataOne",1,0,0,1
"pesu",0,0,0,0,0,0,1,"DataOne",1,0,0,1
"petromyzon marinus",0,0,0,0,0,0,1,"DataOne",1,0,0,1
"pezzetta1962",0,0,0,0,0,0,1,"DataOne",1,0,0,1
"ph,cl,spc",0,0,0,0,0,0,1,"DataOne",1,0,0,1
"ph,cl,spc,tds",0,0,0,0,0,0,1,"DataOne",1,0,0,1
"phar3",0,0,0,0,0,0,1,"DataOne",1,0,0,1
"phc",0,0,0,0,0,0,1,"DataOne",1,0,0,1
"phleger gravity corer",0,0,0,0,0,0,1,"DataOne",1,0,0,1
"phosphate concentrations (um)",0,0,0,0,0,0,1,"DataOne",1,0,0,1
"phreatophytic shrublands",0,0,0,0,0,0,1,"DataOne",1,0,0,1
"phred quality (q) scores (standard deviation)",0,0,0,0,0,0,1,"DataOne",1,0,0,1
"phryganeidae",0,0,0,0,0,0,1,"DataOne",1,0,0,1
"physidae",0,0,0,0,0,0,1,"DataOne",1,0,0,1
"piacenzian",0,0,0,0,0,0,1,"DataOne",1,0,0,1
"pibo",0,0,0,0,0,0,1,"DataOne",1,0,0,1
"picocuries per liter (pci/l)",0,0,0,0,0,0,1,"DataOne",1,0,0,1
"picocuries per liter(pci/l)",0,0,0,0,0,0,1,"DataOne",1,0,0,1
"picomolesperminutepermilligram",0,0,0,0,0,0,1,"DataOne",1,0,0,1
"pictxxxx.jpg",0,0,0,0,0,0,1,"DataOne",1,0,0,1
"pier",0,0,0,0,0,0,1,"DataOne",1,0,0,1
"pigr",0,0,0,0,0,0,1,"DataOne",1,0,0,1
"pilot station, y-k delta",0,0,0,0,0,0,1,"DataOne",1,0,0,1
"pimephales notatus",0,0,0,0,0,0,1,"DataOne",1,0,0,1
"pine ceek (pa)",0,0,0,0,0,0,1,"DataOne",1,0,0,1
"pine creek (pa), delaware river mainstem (pa/ny), upper ammonoosuc river (nh)",0,0,0,0,0,0,1,"DataOne",1,0,0,1
"pinenut",0,0,0,0,0,0,1,"DataOne",1,0,0,1
"pinesburg station dolomite",0,0,0,0,0,0,1,"DataOne",1,0,0,1
"pink",0,0,0,0,0,0,1,"DataOne",1,0,0,1
"pipe creek shale member",0,0,0,0,0,0,1,"DataOne",1,0,0,1
"pipeline",0,0,0,0,0,0,1,"DataOne",1,0,0,1
"pipeline or cable",0,0,0,0,0,0,1,"DataOne",1,0,0,1
"pipo forest",0,0,0,0,0,0,1,"DataOne",1,0,0,1
"pisidiidae",0,0,0,0,0,0,1,"DataOne",1,0,0,1
"piston core",0,0,0,0,0,0,1,"DataOne",1,0,0,1
"pixel",0,0,0,0,0,0,1,"DataOne",1,0,0,1
"pixels",0,0,0,0,0,0,1,"DataOne",1,0,0,1
"placer mine",0,0,0,0,0,0,1,"DataOne",1,0,0,1
"plague",0,0,0,0,0,0,1,"DataOne",1,0,0,1
"planorbidae",0,0,0,0,0,0,1,"DataOne",1,0,0,1
"plaque forming units per ml serum",0,0,0,0,0,0,1,"DataOne",1,0,0,1
"plasmid dna",0,0,0,0,0,0,1,"DataOne",1,0,0,1
"platte river",0,0,0,0,0,0,1,"DataOne",1,0,0,1
"plecoptera",0,0,0,0,0,0,1,"DataOne",1,0,0,1
"plum island",0,0,0,0,0,0,1,"DataOne",1,0,0,1
"pm",0,0,0,0,0,0,1,"DataOne",1,0,0,1
"pmol/min/ml",0,0,0,0,0,0,1,"DataOne",1,0,0,1
"pmolperminutepermiligramprotein",0,0,0,0,0,0,1,"DataOne",1,0,0,1
"pnm (as per nmed)",0,0,0,0,0,0,1,"DataOne",1,0,0,1
"pockmark",0,0,0,0,0,0,1,"DataOne",1,0,0,1
"podicipediformes",0,0,0,0,0,0,1,"DataOne",1,0,0,1
"point",0,0,0,0,0,0,1,"DataOne",1,0,0,1
"point lonely",0,0,0,0,0,0,1,"DataOne",1,0,0,1
"pokejoy member",0,0,0,0,0,0,1,"DataOne",1,0,0,1
"pollock",0,0,0,0,0,0,1,"DataOne",1,0,0,1
"polycentropodidae",0,0,0,0,0,0,1,"DataOne",1,0,0,1
"pomoxis annularis",0,0,0,0,0,0,1,"DataOne",1,0,0,1
"ponar type grab",0,0,0,0,0,0,1,"DataOne",1,0,0,1
"pool",0,0,0,0,0,0,1,"DataOne",1,0,0,1
"poor",0,0,0,0,0,0,1,"DataOne",1,0,0,1
"pope2",0,0,0,0,0,0,1,"DataOne",1,0,0,1
"poppe",0,0,0,0,0,0,1,"DataOne",1,0,0,1
"por",0,0,0,0,0,0,1,"DataOne",1,0,0,1
"porcupine river",0,0,0,0,0,0,1,"DataOne",1,0,0,1
"portland parks and rec",0,0,0,0,0,0,1,"DataOne",1,0,0,1
"pos",0,0,0,0,0,0,1,"DataOne",1,0,0,1
"pos",0,0,0,0,0,0,1,"DataOne",1,0,0,1
"positive for visible n. salminicola",0,0,0,0,0,0,1,"DataOne",1,0,0,1
"pouncing",0,0,0,0,0,0,1,"DataOne",1,0,0,1
"powell",0,0,0,0,0,0,1,"DataOne",1,0,0,1
"pr",0,0,0,0,0,0,1,"DataOne",1,0,0,1
"pr_ppm_ms_st",0,0,0,0,0,0,1,"DataOne",1,0,0,1
"pr_ppm_ms_st_ree",0,0,0,0,0,0,1,"DataOne",1,0,0,1
"practical salinity units (psu)",0,0,0,0,0,0,1,"DataOne",1,0,0,1
"practical salinity units (psu)",0,0,0,0,0,0,1,"DataOne",1,0,0,1
"prairie dogs",0,0,0,0,0,0,1,"DataOne",1,0,0,1
"predator",0,0,0,0,0,0,1,"DataOne",1,0,0,1
"present(1) or absent(0)",0,0,0,0,0,0,1,"DataOne",1,0,0,1
"primary",0,0,0,0,0,0,1,"DataOne",1,0,0,1
"prince of wales passage",0,0,0,0,0,0,1,"DataOne",1,0,0,1
"prince william sound",0,0,0,0,0,0,1,"DataOne",1,0,0,1
"prism mc1",0,0,0,0,0,0,1,"DataOne",1,0,0,1
"priv",0,0,0,0,0,0,1,"DataOne",1,0,0,1
"private land",0,0,0,0,0,0,1,"DataOne",1,0,0,1
"producer defined",0,0,0,0,0,0,1,"DataOne",1,0,0,1
"producer defined by u.s. geological survey",0,0,0,0,0,0,1,"DataOne",1,0,0,1
"projects",0,0,0,0,0,0,1,"DataOne",1,0,0,1
"proportion of agriculture per county",0,0,0,0,0,0,1,"DataOne",1,0,0,1
"proportion of the 24-hr cycle",0,0,0,0,0,0,1,"DataOne",1,0,0,1
"prospect pit",0,0,0,0,0,0,1,"DataOne",1,0,0,1
"pss",0,0,0,0,0,0,1,"DataOne",1,0,0,1
"pt",0,0,0,0,0,0,1,"DataOne",1,0,0,1
"pt_ppm_fa_ms",0,0,0,0,0,0,1,"DataOne",1,0,0,1
"ptc",0,0,0,0,0,0,1,"DataOne",1,0,0,1
"ptg",0,0,0,0,0,0,1,"DataOne",1,0,0,1
"pumice pit",0,0,0,0,0,0,1,"DataOne",1,0,0,1
"pumpkinseed",0,0,0,0,0,0,1,"DataOne",1,0,0,1
"pupa",0,0,0,0,0,0,1,"DataOne",1,0,0,1
"purcell limestone member",0,0,0,0,0,0,1,"DataOne",1,0,0,1
"push core",0,0,0,0,0,0,1,"DataOne",1,0,0,1
"puyallup",0,0,0,0,0,0,1,"DataOne",1,0,0,1
"pws",0,0,0,0,0,0,1,"DataOne",1,0,0,1
"pyco4",0,0,0,0,0,0,1,"DataOne",1,0,0,1
"pz",0,0,0,0,0,0,1,"DataOne",1,0,0,1
"qaasuitsup",0,0,0,0,0,0,1,"DataOne",1,0,0,1
"qaf",0,0,0,0,0,0,1,"DataOne",1,0,0,1
"qcb",0,0,0,0,0,0,1,"DataOne",1,0,0,1
"qci",0,0,0,0,0,0,1,"DataOne",1,0,0,1
"qcp",0,0,0,0,0,0,1,"DataOne",1,0,0,1
"qcpb",0,0,0,0,0,0,1,"DataOne",1,0,0,1
"qcrb",0,0,0,0,0,0,1,"DataOne",1,0,0,1
"qcrc",0,0,0,0,0,0,1,"DataOne",1,0,0,1
"qd - silty clay",0,0,0,0,0,0,1,"DataOne",1,0,0,1
"qgcc1",0,0,0,0,0,0,1,"DataOne",1,0,0,1
"qgcc2",0,0,0,0,0,0,1,"DataOne",1,0,0,1
"qgcc3",0,0,0,0,0,0,1,"DataOne",1,0,0,1
"qgcf",0,0,0,0,0,0,1,"DataOne",1,0,0,1
"qgpc",0,0,0,0,0,0,1,"DataOne",1,0,0,1
"qgpf",0,0,0,0,0,0,1,"DataOne",1,0,0,1
"qmp",0,0,0,0,0,0,1,"DataOne",1,0,0,1
"qms",0,0,0,0,0,0,1,"DataOne",1,0,0,1
"qms/qtbu",0,0,0,0,0,0,1,"DataOne",1,0,0,1
"qms/tbu",0,0,0,0,0,0,1,"DataOne",1,0,0,1
"qms/tm",0,0,0,0,0,0,1,"DataOne",1,0,0,1
"qms/tm?",0,0,0,0,0,0,1,"DataOne",1,0,0,1
"qmsc",0,0,0,0,0,0,1,"DataOne",1,0,0,1
"qmsc?",0,0,0,0,0,0,1,"DataOne",1,0,0,1
"qmscl",0,0,0,0,0,0,1,"DataOne",1,0,0,1
"qmscl?",0,0,0,0,0,0,1,"DataOne",1,0,0,1
"qmsf",0,0,0,0,0,0,1,"DataOne",1,0,0,1
"qmsl",0,0,0,0,0,0,1,"DataOne",1,0,0,1
"qsf",0,0,0,0,0,0,1,"DataOne",1,0,0,1
"qtbu",0,0,0,0,0,0,1,"DataOne",1,0,0,1
"qts1",0,0,0,0,0,0,1,"DataOne",1,0,0,1
"qts2",0,0,0,0,0,0,1,"DataOne",1,0,0,1
"qts3",0,0,0,0,0,0,1,"DataOne",1,0,0,1
"qu - gravel, cobbles",0,0,0,0,0,0,1,"DataOne",1,0,0,1
"qu - muddy sand",0,0,0,0,0,0,1,"DataOne",1,0,0,1
"qu - sand",0,0,0,0,0,0,1,"DataOne",1,0,0,1
"qu - sand and gravel",0,0,0,0,0,0,1,"DataOne",1,0,0,1
"qu (qgl) - silty clay",0,0,0,0,0,0,1,"DataOne",1,0,0,1
"quantity",0,0,0,0,0,0,1,"DataOne",1,0,0,1
"quarry",0,0,0,0,0,0,1,"DataOne",1,0,0,1
"quarry - gypsum",0,0,0,0,0,0,1,"DataOne",1,0,0,1
"quarry - limestone",0,0,0,0,0,0,1,"DataOne",1,0,0,1
"quarry - pumice",0,0,0,0,0,0,1,"DataOne",1,0,0,1
"quarry - rock",0,0,0,0,0,0,1,"DataOne",1,0,0,1
"quartz diorite",0,0,0,0,0,0,1,"DataOne",1,0,0,1
"quartz monzonite",0,0,0,0,0,0,1,"DataOne",1,0,0,1
"quaternary - paleochannel fill",0,0,0,0,0,0,1,"DataOne",1,0,0,1
"quicks hole",0,0,0,0,0,0,1,"DataOne",1,0,0,1
"quinhagak, y-k delta",0,0,0,0,0,0,1,"DataOne",1,0,0,1
"quinine sulfate units (qsu), where 1 qsu = 1 part per billion of quinine sulfate, which has fluorescence properties similar to that of organic matter; no data value 999 (not used in calculations)",0,0,0,0,0,0,1,"DataOne",1,0,0,1
"quissett freezer van: fr01",0,0,0,0,0,0,1,"DataOne",1,0,0,1
"r-p",0,0,0,0,0,0,1,"DataOne",1,0,0,1
"r/l",0,0,0,0,0,0,1,"DataOne",1,0,0,1
"rafa04011",0,0,0,0,0,0,1,"DataOne",1,0,0,1
"rafa05007",0,0,0,0,0,0,1,"DataOne",1,0,0,1
"rafa06005",0,0,0,0,0,0,1,"DataOne",1,0,0,1
"rafa07034",0,0,0,0,0,0,1,"DataOne",1,0,0,1
"rafa08012",0,0,0,0,0,0,1,"DataOne",1,0,0,1
"rafael",0,0,0,0,0,0,1,"DataOne",1,0,0,1
"rain",0,0,0,0,0,0,1,"DataOne",1,0,0,1
"rain",0,0,0,0,0,0,1,"DataOne",1,0,0,1
"rain; light wind",0,0,0,0,0,0,1,"DataOne",1,0,0,1
"rain; thunder",0,0,0,0,0,0,1,"DataOne",1,0,0,1
"rain; wind",0,0,0,0,0,0,1,"DataOne",1,0,0,1
"rain; wind; thunder",0,0,0,0,0,0,1,"DataOne",1,0,0,1
"rain?",0,0,0,0,0,0,1,"DataOne",1,0,0,1
"rainbow paradise trout farm (pa)",0,0,0,0,0,0,1,"DataOne",1,0,0,1
"rainbow trout",0,0,0,0,0,0,1,"DataOne",1,0,0,1
"rana draytonii",0,0,0,0,0,0,1,"DataOne",1,0,0,1
"randomized",0,0,0,0,0,0,1,"DataOne",1,0,0,1
"rat",0,0,0,0,0,0,1,"DataOne",1,0,0,1
"rattlebox",0,0,0,0,0,0,1,"DataOne",1,0,0,1
"rb",0,0,0,0,0,0,1,"DataOne",1,0,0,1
"rb_ppm_edx",0,0,0,0,0,0,1,"DataOne",1,0,0,1
"rb_ppm_ms_st",0,0,0,0,0,0,1,"DataOne",1,0,0,1
"rb_ppm_na_lc",0,0,0,0,0,0,1,"DataOne",1,0,0,1
"rb_ppm_na_sc",0,0,0,0,0,0,1,"DataOne",1,0,0,1
"rbm",0,0,0,0,0,0,1,"DataOne",1,0,0,1
"rbme",0,0,0,0,0,0,1,"DataOne",1,0,0,1
"rbt",0,0,0,0,0,0,1,"DataOne",1,0,0,1
"rcd",0,0,0,0,0,0,1,"DataOne",1,0,0,1
"rd cl",0,0,0,0,0,0,1,"DataOne",1,0,0,1
"recaptured",0,0,0,0,0,0,1,"DataOne",1,0,0,1
"reciprocal dilution factor",0,0,0,0,0,0,1,"DataOne",1,0,0,1
"rectified air photo",0,0,0,0,0,0,1,"DataOne",1,0,0,1
"rectified air photos",0,0,0,0,0,0,1,"DataOne",1,0,0,1
"red maple",0,0,0,0,0,0,1,"DataOne",1,0,0,1
"redband",0,0,0,0,0,0,1,"DataOne",1,0,0,1
"redrock",0,0,0,0,0,0,1,"DataOne",1,0,0,1
"reference map usgs drg",0,0,0,0,0,0,1,"DataOne",1,0,0,1
"regular",0,0,0,0,0,0,1,"DataOne",1,0,0,1
"regular",0,0,0,0,0,0,1,"DataOne",1,0,0,1
"reidetal1982",0,0,0,0,0,0,1,"DataOne",1,0,0,1
"rekn",0,0,0,0,0,0,1,"DataOne",1,0,0,1
"remediation",0,0,0,0,0,0,1,"DataOne",1,0,0,1
"remigial molt",0,0,0,0,0,0,1,"DataOne",1,0,0,1
"rendigs",0,0,0,0,0,0,1,"DataOne",1,0,0,1
"repetski, j. e., and others, 2008",0,0,0,0,0,0,1,"DataOne",1,0,0,1
"replace",0,0,0,0,0,0,1,"DataOne",1,0,0,1
"replicate",0,0,0,0,0,0,1,"DataOne",1,0,0,1
"restored",0,0,0,0,0,0,1,"DataOne",1,0,0,1
"resurrection river",0,0,0,0,0,0,1,"DataOne",1,0,0,1
"revolution no 9",0,0,0,0,0,0,1,"DataOne",1,0,0,1
"reworked over lake",0,0,0,0,0,0,1,"DataOne",1,0,0,1
"rh",0,0,0,0,0,0,1,"DataOne",1,0,0,1
"rh",0,0,0,0,0,0,1,"DataOne",1,0,0,1
"rh_ppm_fa_ms",0,0,0,0,0,0,1,"DataOne",1,0,0,1
"rhinestreet shale member",0,0,0,0,0,0,1,"DataOne",1,0,0,1
"rhinichthys atratulus",0,0,0,0,0,0,1,"DataOne",1,0,0,1
"rhinichthys cataractae",0,0,0,0,0,0,1,"DataOne",1,0,0,1
"rho",0,0,0,0,0,0,1,"DataOne",1,0,0,1
"ridgeswale",0,0,0,0,0,0,1,"DataOne",1,0,0,1
"riley, r.a., and others, 2012",0,0,0,0,0,0,1,"DataOne",1,0,0,1
"riparian",0,0,0,0,0,0,1,"DataOne",1,0,0,1
"riparian areas",0,0,0,0,0,0,1,"DataOne",1,0,0,1
"rise",0,0,0,0,0,0,1,"DataOne",1,0,0,1
"rissa tridactyla",0,0,0,0,0,0,1,"DataOne",1,0,0,1
"rita's ride",0,0,0,0,0,0,1,"DataOne",1,0,0,1
"riverside county",0,0,0,0,0,0,1,"DataOne",1,0,0,1
"rmb066",0,0,0,0,0,0,1,"DataOne",1,0,0,1
"road",0,0,0,0,0,0,1,"DataOne",1,0,0,1
"robb",0,0,0,0,0,0,1,"DataOne",1,0,0,1
"rock",0,0,0,0,0,0,1,"DataOne",1,0,0,1
"rock bass",0,0,0,0,0,0,1,"DataOne",1,0,0,1
"rock dredge",0,0,0,0,0,0,1,"DataOne",1,0,0,1
"rockdale run formation",0,0,0,0,0,0,1,"DataOne",1,0,0,1
"rockeval",0,0,0,0,0,0,1,"DataOne",1,0,0,1
"rocking chair dredge",0,0,0,0,0,0,1,"DataOne",1,0,0,1
"rocks",0,0,0,0,0,0,1,"DataOne",1,0,0,1
"rocky bottom",0,0,0,0,0,0,1,"DataOne",1,0,0,1
"rocky point",0,0,0,0,0,0,1,"DataOne",1,0,0,1
"roger b simons",0,0,0,0,0,0,1,"DataOne",1,0,0,1
"rolling in snow",0,0,0,0,0,0,1,"DataOne",1,0,0,1
"romu",0,0,0,0,0,0,1,"DataOne",1,0,0,1
"root mean squared error",0,0,0,0,0,0,1,"DataOne",1,0,0,1
"ropi",0,0,0,0,0,0,1,"DataOne",1,0,0,1
"round mountain",0,0,0,0,0,0,1,"DataOne",1,0,0,1
"routine",0,0,0,0,0,0,1,"DataOne",1,0,0,1
"rov push core",0,0,0,0,0,0,1,"DataOne",1,0,0,1
"rowe1978",0,0,0,0,0,0,1,"DataOne",1,0,0,1
"ru",0,0,0,0,0,0,1,"DataOne",1,0,0,1
"ru_ppm_fa_ms",0,0,0,0,0,0,1,"DataOne",1,0,0,1
"rubbing",0,0,0,0,0,0,1,"DataOne",1,0,0,1
"rudbe",0,0,0,0,0,0,1,"DataOne",1,0,0,1
"running",0,0,0,0,0,0,1,"DataOne",1,0,0,1
"running and walking",0,0,0,0,0,0,1,"DataOne",1,0,0,1
"russia",0,0,0,0,0,0,1,"DataOne",1,0,0,1
"rz",0,0,0,0,0,0,1,"DataOne",1,0,0,1
"s_pct_aes_st",0,0,0,0,0,0,1,"DataOne",1,0,0,1
"sacatar",0,0,0,0,0,0,1,"DataOne",1,0,0,1
"sagavanirktok river",0,0,0,0,0,0,1,"DataOne",1,0,0,1
"sain3",0,0,0,0,0,0,1,"DataOne",1,0,0,1
"salix",0,0,0,0,0,0,1,"DataOne",1,0,0,1
"salmo salar",0,0,0,0,0,0,1,"DataOne",1,0,0,1
"salmon",0,0,0,0,0,0,1,"DataOne",1,0,0,1
"sals",0,0,0,0,0,0,1,"DataOne",1,0,0,1
"salt evaporator",0,0,0,0,0,0,1,"DataOne",1,0,0,1
"salt flat",0,0,0,0,0,0,1,"DataOne",1,0,0,1
"salvelinus fontinalis",0,0,0,0,0,0,1,"DataOne",1,0,0,1
"sam-10",0,0,0,0,0,0,1,"DataOne",1,0,0,1
"san juan islands",0,0,0,0,0,0,1,"DataOne",1,0,0,1
"sand-gravel",0,0,0,0,0,0,1,"DataOne",1,0,0,1
"sand-silt",0,0,0,0,0,0,1,"DataOne",1,0,0,1
"sand-silt-clay",0,0,0,0,0,0,1,"DataOne",1,0,0,1
"sand - sand wave",0,0,0,0,0,0,1,"DataOne",1,0,0,1
"sand - tidal inlet",0,0,0,0,0,0,1,"DataOne",1,0,0,1
"sand and gravel",0,0,0,0,0,0,1,"DataOne",1,0,0,1
"sand and gravel pit",0,0,0,0,0,0,1,"DataOne",1,0,0,1
"sand canyon",0,0,0,0,0,0,1,"DataOne",1,0,0,1
"sand lance",0,0,0,0,0,0,1,"DataOne",1,0,0,1
"sand pit",0,0,0,0,0,0,1,"DataOne",1,0,0,1
"sand silt clay",0,0,0,0,0,0,1,"DataOne",1,0,0,1
"sand waves",0,0,0,0,0,0,1,"DataOne",1,0,0,1
"sand waves/megaripples",0,0,0,0,0,0,1,"DataOne",1,0,0,1
"sand, shells, and gravel",0,0,0,0,0,0,1,"DataOne",1,0,0,1
"sandy mud - mottled",0,0,0,0,0,0,1,"DataOne",1,0,0,1
"sandy silt",0,0,0,0,0,0,1,"DataOne",1,0,0,1
"sandy silt-clay",0,0,0,0,0,0,1,"DataOne",1,0,0,1
"saph",0,0,0,0,0,0,1,"DataOne",1,0,0,1
"saskatchewan",0,0,0,0,0,0,1,"DataOne",1,0,0,1
"saturated soil",0,0,0,0,0,0,1,"DataOne",1,0,0,1
"saturated soil non-forest",0,0,0,0,0,0,1,"DataOne",1,0,0,1
"sauksuiattle",0,0,0,0,0,0,1,"DataOne",1,0,0,1
"savard66",0,0,0,0,0,0,1,"DataOne",1,0,0,1
"sb",0,0,0,0,0,0,1,"DataOne",1,0,0,1
"sb-04",0,0,0,0,0,0,1,"DataOne",1,0,0,1
"sb-15",0,0,0,0,0,0,1,"DataOne",1,0,0,1
"sb_ppm_aes_az_p",0,0,0,0,0,0,1,"DataOne",1,0,0,1
"sb_ppm_es_sq",0,0,0,0,0,0,1,"DataOne",1,0,0,1
"sb_ppm_ms_st",0,0,0,0,0,0,1,"DataOne",1,0,0,1
"sb_ppm_na_lc",0,0,0,0,0,0,1,"DataOne",1,0,0,1
"sb_ppm_na_sc",0,0,0,0,0,0,1,"DataOne",1,0,0,1
"sbc",0,0,0,0,0,0,1,"DataOne",1,0,0,1
"sbnms",0,0,0,0,0,0,1,"DataOne",1,0,0,1
"sbs",0,0,0,0,0,0,1,"DataOne",1,0,0,1
"sc",0,0,0,0,0,0,1,"DataOne",1,0,0,1
"sc_ppm_aes_st",0,0,0,0,0,0,1,"DataOne",1,0,0,1
"sc_ppm_es_sq",0,0,0,0,0,0,1,"DataOne",1,0,0,1
"sc_ppm_na_lc",0,0,0,0,0,0,1,"DataOne",1,0,0,1
"sc_ppm_na_sc",0,0,0,0,0,0,1,"DataOne",1,0,0,1
"scallop derdge",0,0,0,0,0,0,1,"DataOne",1,0,0,1
"scanlon",0,0,0,0,0,0,1,"DataOne",1,0,0,1
"scd",0,0,0,0,0,0,1,"DataOne",1,0,0,1
"scen",0,0,0,0,0,0,1,"DataOne",1,0,0,1
"schlee_etal1973",0,0,0,0,0,0,1,"DataOne",1,0,0,1
"schwab",0,0,0,0,0,0,1,"DataOne",1,0,0,1
"schwartz65",0,0,0,0,0,0,1,"DataOne",1,0,0,1
"scoop",0,0,0,0,0,0,1,"DataOne",1,0,0,1
"scoria pit",0,0,0,0,0,0,1,"DataOne",1,0,0,1
"scour depression",0,0,0,0,0,0,1,"DataOne",1,0,0,1
"scour depression",0,0,0,0,0,0,1,"DataOne",1,0,0,1
"sculpin (scp) 10",0,0,0,0,0,0,1,"DataOne",1,0,0,1
"sculpin (scp) 16",0,0,0,0,0,0,1,"DataOne",1,0,0,1
"sculpin (scp) 2",0,0,0,0,0,0,1,"DataOne",1,0,0,1
"sculpin (scp) 27",0,0,0,0,0,0,1,"DataOne",1,0,0,1
"sculpin (scp) 7",0,0,0,0,0,0,1,"DataOne",1,0,0,1
"scwsc_may2010_data",0,0,0,0,0,0,1,"DataOne",1,0,0,1
"sd",0,0,0,0,0,0,1,"DataOne",1,0,0,1
"sd-cl/st",0,0,0,0,0,0,1,"DataOne",1,0,0,1
"sd-st/cl",0,0,0,0,0,0,1,"DataOne",1,0,0,1
"sd/st/cl",0,0,0,0,0,0,1,"DataOne",1,0,0,1
"sdallv-09",0,0,0,0,0,0,1,"DataOne",1,0,0,1
"sdd",0,0,0,0,0,0,1,"DataOne",1,0,0,1
"sdhdrk-09",0,0,0,0,0,0,1,"DataOne",1,0,0,1
"sdwarn-02",0,0,0,0,0,0,1,"DataOne",1,0,0,1
"se",0,0,0,0,0,0,1,"DataOne",1,0,0,1
"se_ppm_ms_st",0,0,0,0,0,0,1,"DataOne",1,0,0,1
"sea ice",0,0,0,0,0,0,1,"DataOne",1,0,0,1
"sea lamprey (ammocoete)",0,0,0,0,0,0,1,"DataOne",1,0,0,1
"seabird",0,0,0,0,0,0,1,"DataOne",1,0,0,1
"seaboss (big)",0,0,0,0,0,0,1,"DataOne",1,0,0,1
"seak",0,0,0,0,0,0,1,"DataOne",1,0,0,1
"seas",0,0,0,0,0,0,1,"DataOne",1,0,0,1
"seaward explorer",0,0,0,0,0,0,1,"DataOne",1,0,0,1
"second of the day",0,0,0,0,0,0,1,"DataOne",1,0,0,1
"seconds of run time 1575",0,0,0,0,0,0,1,"DataOne",1,0,0,1
"seconds of run time 244",0,0,0,0,0,0,1,"DataOne",1,0,0,1
"seconds of run time 2510",0,0,0,0,0,0,1,"DataOne",1,0,0,1
"seconds of run time 4392",0,0,0,0,0,0,1,"DataOne",1,0,0,1
"seconds of run time 740",0,0,0,0,0,0,1,"DataOne",1,0,0,1
"seconds of run time 749",0,0,0,0,0,0,1,"DataOne",1,0,0,1
"seconds of run time 786",0,0,0,0,0,0,1,"DataOne",1,0,0,1
"seconds of run time 856",0,0,0,0,0,0,1,"DataOne",1,0,0,1
"seconds since january 1 1970",0,0,0,0,0,0,1,"DataOne",1,0,0,1
"sediment",0,0,0,0,0,0,1,"DataOne",1,0,0,1
"sediment drill",0,0,0,0,0,0,1,"DataOne",1,0,0,1
"seed",0,0,0,0,0,0,1,"DataOne",1,0,0,1
"seismic shot number",0,0,0,0,0,0,1,"DataOne",1,0,0,1
"seismic shot number, first, last and 100-shot intervals",0,0,0,0,0,0,1,"DataOne",1,0,0,1
"semi",0,0,0,0,0,0,1,"DataOne",1,0,0,1
"semi-permanent wetland",0,0,0,0,0,0,1,"DataOne",1,0,0,1
"semipermanent wetland",0,0,0,0,0,0,1,"DataOne",1,0,0,1
"seor",0,0,0,0,0,0,1,"DataOne",1,0,0,1
"seow",0,0,0,0,0,0,1,"DataOne",1,0,0,1
"sepl",0,0,0,0,0,0,1,"DataOne",1,0,0,1
"sesa",0,0,0,0,0,0,1,"DataOne",1,0,0,1
"settling pond",0,0,0,0,0,0,1,"DataOne",1,0,0,1
"seward johnson",0,0,0,0,0,0,1,"DataOne",1,0,0,1
"seward johnson/jsl",0,0,0,0,0,0,1,"DataOne",1,0,0,1
"sf",0,0,0,0,0,0,1,"DataOne",1,0,0,1
"sfg",0,0,0,0,0,0,1,"DataOne",1,0,0,1
"sfwmd site_id listed in otid",0,0,0,0,0,0,1,"DataOne",1,0,0,1
"sfwmd_may2010_data",0,0,0,0,0,0,1,"DataOne",1,0,0,1
"sgs",0,0,0,0,0,0,1,"DataOne",1,0,0,1
"shale pit",0,0,0,0,0,0,1,"DataOne",1,0,0,1
"shaver creek (pa)",0,0,0,0,0,0,1,"DataOne",1,0,0,1
"shc",0,0,0,0,0,0,1,"DataOne",1,0,0,1
"shell",0,0,0,0,0,0,1,"DataOne",1,0,0,1
"shell pit",0,0,0,0,0,0,1,"DataOne",1,0,0,1
"shell zones",0,0,0,0,0,0,1,"DataOne",1,0,0,1
"shell/gravel",0,0,0,0,0,0,1,"DataOne",1,0,0,1
"shell_gravel_cobble",0,0,0,0,0,0,1,"DataOne",1,0,0,1
"shellbed",0,0,0,0,0,0,1,"DataOne",1,0,0,1
"shelly sand",0,0,0,0,0,0,1,"DataOne",1,0,0,1
"sheltered coasts",0,0,0,0,0,0,1,"DataOne",1,0,0,1
"shield darter",0,0,0,0,0,0,1,"DataOne",1,0,0,1
"ship's wake",0,0,0,0,0,0,1,"DataOne",1,0,0,1
"shipeck grab",0,0,0,0,0,0,1,"DataOne",1,0,0,1
"shoal - sand waves",0,0,0,0,0,0,1,"DataOne",1,0,0,1
"shore-detached shoal",0,0,0,0,0,0,1,"DataOne",1,0,0,1
"shorebird",0,0,0,0,0,0,1,"DataOne",1,0,0,1
"shoreline",0,0,0,0,0,0,1,"DataOne",1,0,0,1
"shortnose sturgeon",0,0,0,0,0,0,1,"DataOne",1,0,0,1
"shot point",0,0,0,0,0,0,1,"DataOne",1,0,0,1
"shrimp",0,0,0,0,0,0,1,"DataOne",1,0,0,1
"shriver chert",0,0,0,0,0,0,1,"DataOne",1,0,0,1
"shrub",0,0,0,0,0,0,1,"DataOne",1,0,0,1
"shrub/scrub",0,0,0,0,0,0,1,"DataOne",1,0,0,1
"shrubs - wet meadow shrubs (>25%, typically alder, dogwood, elder, false indigo and/or willow) occurring with mixed sedge and/or grasses/forbs understory",0,0,0,0,0,0,1,"DataOne",1,0,0,1
"shs",0,0,0,0,0,0,1,"DataOne",1,0,0,1
"si",0,0,0,0,0,0,1,"DataOne",1,0,0,1
"si",0,0,0,0,0,0,1,"DataOne",1,0,0,1
"si_pct_aes_st",0,0,0,0,0,0,1,"DataOne",1,0,0,1
"si_pct_wdx_fuse",0,0,0,0,0,0,1,"DataOne",1,0,0,1
"silica mine",0,0,0,0,0,0,1,"DataOne",1,0,0,1
"silicic acid concentrations, micromolar (um)",0,0,0,0,0,0,1,"DataOne",1,0,0,1
"silt",0,0,0,0,0,0,1,"DataOne",1,0,0,1
"silt-clay",0,0,0,0,0,0,1,"DataOne",1,0,0,1
"silt-f.sand",0,0,0,0,0,0,1,"DataOne",1,0,0,1
"silt-sand",0,0,0,0,0,0,1,"DataOne",1,0,0,1
"silt-v.f sand",0,0,0,0,0,0,1,"DataOne",1,0,0,1
"silt clay",0,0,0,0,0,0,1,"DataOne",1,0,0,1
"silt, sand and gravel",0,0,0,0,0,0,1,"DataOne",1,0,0,1
"silt, shells, and gravel",0,0,0,0,0,0,1,"DataOne",1,0,0,1
"silts",0,0,0,0,0,0,1,"DataOne",1,0,0,1
"silty clay",0,0,0,0,0,0,1,"DataOne",1,0,0,1
"silty fine coarse sand",0,0,0,0,0,0,1,"DataOne",1,0,0,1
"silty fine sand",0,0,0,0,0,0,1,"DataOne",1,0,0,1
"silty medium sand",0,0,0,0,0,0,1,"DataOne",1,0,0,1
"silty sand and gravel",0,0,0,0,0,0,1,"DataOne",1,0,0,1
"silurian",0,0,0,0,0,0,1,"DataOne",1,0,0,1
"simuliidae",0,0,0,0,0,0,1,"DataOne",1,0,0,1
"single",0,0,0,0,0,0,1,"DataOne",1,0,0,1
"singleplex",0,0,0,0,0,0,1,"DataOne",1,0,0,1
"singletreeselection",0,0,0,0,0,0,1,"DataOne",1,0,0,1
"sio2",0,0,0,0,0,0,1,"DataOne",1,0,0,1
"sio2_pct_wdx_fuse",0,0,0,0,0,0,1,"DataOne",1,0,0,1
"site id cane creek id-021",0,0,0,0,0,0,1,"DataOne",1,0,0,1
"site id cinnabar creek id-019",0,0,0,0,0,0,1,"DataOne",1,0,0,1
"site id sugar (down) creek above west end creek id-010",0,0,0,0,0,0,1,"DataOne",1,0,0,1
"site id sugar (mid) creek below cinnabar creek id-018",0,0,0,0,0,0,1,"DataOne",1,0,0,1
"site id sugar (up) creek above cane creek id-020",0,0,0,0,0,0,1,"DataOne",1,0,0,1
"site location (utm) 11n 632538 4977500",0,0,0,0,0,0,1,"DataOne",1,0,0,1
"site location (utm) 11n 633653 4978402",0,0,0,0,0,0,1,"DataOne",1,0,0,1
"site location (utm) 11n 634736 4979022",0,0,0,0,0,0,1,"DataOne",1,0,0,1
"site location (utm) 11n 634751 4979176",0,0,0,0,0,0,1,"DataOne",1,0,0,1
"site location utm 11n 634713 4979190",0,0,0,0,0,0,1,"DataOne",1,0,0,1
"site_id",0,0,0,0,0,0,1,"DataOne",1,0,0,1
"sitting or laying",0,0,0,0,0,0,1,"DataOne",1,0,0,1
"sitting or standing",0,0,0,0,0,0,1,"DataOne",1,0,0,1
"sj73",0,0,0,0,0,0,1,"DataOne",1,0,0,1
"sjcm",0,0,0,0,0,0,1,"DataOne",1,0,0,1
"sjgs",0,0,0,0,0,0,1,"DataOne",1,0,0,1
"sjhn08008",0,0,0,0,0,0,1,"DataOne",1,0,0,1
"sji",0,0,0,0,0,0,1,"DataOne",1,0,0,1
"skagit",0,0,0,0,0,0,1,"DataOne",1,0,0,1
"skaneateles shale",0,0,0,0,0,0,1,"DataOne",1,0,0,1
"skin",0,0,0,0,0,0,1,"DataOne",1,0,0,1
"skokomish",0,0,0,0,0,0,1,"DataOne",1,0,0,1
"slag pile",0,0,0,0,0,0,1,"DataOne",1,0,0,1
"slc",0,0,0,0,0,0,1,"DataOne",1,0,0,1
"slide hammer core",0,0,0,0,0,0,1,"DataOne",1,0,0,1
"slimy sculpin",0,0,0,0,0,0,1,"DataOne",1,0,0,1
"sm_ppm_ms_st",0,0,0,0,0,0,1,"DataOne",1,0,0,1
"sm_ppm_ms_st_ree",0,0,0,0,0,0,1,"DataOne",1,0,0,1
"sm_ppm_na_lc",0,0,0,0,0,0,1,"DataOne",1,0,0,1
"sm_ppm_na_sc",0,0,0,0,0,0,1,"DataOne",1,0,0,1
"small seaboss",0,0,0,0,0,0,1,"DataOne",1,0,0,1
"smallmouth bass",0,0,0,0,0,0,1,"DataOne",1,0,0,1
"smelling snow",0,0,0,0,0,0,1,"DataOne",1,0,0,1
"smg",0,0,0,0,0,0,1,"DataOne",1,0,0,1
"smith-mcintyre grab",0,0,0,0,0,0,1,"DataOne",1,0,0,1
"smithsonian",0,0,0,0,0,0,1,"DataOne",1,0,0,1
"sn",0,0,0,0,0,0,1,"DataOne",1,0,0,1
"sn_ppm_es_sq",0,0,0,0,0,0,1,"DataOne",1,0,0,1
"sn_ppm_ms_st",0,0,0,0,0,0,1,"DataOne",1,0,0,1
"snag",0,0,0,0,0,0,1,"DataOne",1,0,0,1
"snag",0,0,0,0,0,0,1,"DataOne",1,0,0,1
"snail",0,0,0,0,0,0,1,"DataOne",1,0,0,1
"snail",0,0,0,0,0,0,1,"DataOne",1,0,0,1
"snail count/transect area",0,0,0,0,0,0,1,"DataOne",1,0,0,1
"snapped point to grid cell off nhd flowline",0,0,0,0,0,0,1,"DataOne",1,0,0,1
"snapped point to grid cell on appropriate nhd flowline",0,0,0,0,0,0,1,"DataOne",1,0,0,1
"snapped point to grid cell on nhd flowline",0,0,0,0,0,0,1,"DataOne",1,0,0,1
"snapped point to grid cell with greater fac",0,0,0,0,0,0,1,"DataOne",1,0,0,1
"snbu",0,0,0,0,0,0,1,"DataOne",1,0,0,1
"snoqualmie",0,0,0,0,0,0,1,"DataOne",1,0,0,1
"sockeye",0,0,0,0,0,0,1,"DataOne",1,0,0,1
"solid",0,0,0,0,0,0,1,"DataOne",1,0,0,1
"soos creek hatchery, wa",0,0,0,0,0,0,1,"DataOne",1,0,0,1
"sorted",0,0,0,0,0,0,1,"DataOne",1,0,0,1
"sorting and reworking",0,0,0,0,0,0,1,"DataOne",1,0,0,1
"sosa-06",0,0,0,0,0,0,1,"DataOne",1,0,0,1
"source",0,0,0,0,0,0,1,"DataOne",1,0,0,1
"sourcefilename example: ""sc.it1.ts2001.tif""",0,0,0,0,0,0,1,"DataOne",1,0,0,1
"south tennessee",0,0,0,0,0,0,1,"DataOne",1,0,0,1
"southcentral",0,0,0,0,0,0,1,"DataOne",1,0,0,1
"southern illinois",0,0,0,0,0,0,1,"DataOne",1,0,0,1
"spain segre river",0,0,0,0,0,0,1,"DataOne",1,0,0,1
"sparse grassland",0,0,0,0,0,0,1,"DataOne",1,0,0,1
"species",0,0,0,0,0,0,1,"DataOne",1,0,0,1
"spg",0,0,0,0,0,0,1,"DataOne",1,0,0,1
"spn",0,0,0,0,0,0,1,"DataOne",1,0,0,1
"spoils",0,0,0,0,0,0,1,"DataOne",1,0,0,1
"sponge",0,0,0,0,0,0,1,"DataOne",1,0,0,1
"spotfin shiner",0,0,0,0,0,0,1,"DataOne",1,0,0,1
"spring 2013",0,0,0,0,0,0,1,"DataOne",1,0,0,1
"sps",0,0,0,0,0,0,1,"DataOne",1,0,0,1
"spsa",0,0,0,0,0,0,1,"DataOne",1,0,0,1
"sqkm",0,0,0,0,0,0,1,"DataOne",1,0,0,1
"square-kilometers",0,0,0,0,0,0,1,"DataOne",1,0,0,1
"square meters per square second",0,0,0,0,0,0,1,"DataOne",1,0,0,1
"sr_ppm_aes_st",0,0,0,0,0,0,1,"DataOne",1,0,0,1
"sr_ppm_edx",0,0,0,0,0,0,1,"DataOne",1,0,0,1
"sr_ppm_es_sq",0,0,0,0,0,0,1,"DataOne",1,0,0,1
"sr_ppm_na_lc",0,0,0,0,0,0,1,"DataOne",1,0,0,1
"sr_ppm_na_sc",0,0,0,0,0,0,1,"DataOne",1,0,0,1
"srwmd site_id listed in otid",0,0,0,0,0,0,1,"DataOne",1,0,0,1
"srwmd_may2010_data",0,0,0,0,0,0,1,"DataOne",1,0,0,1
"ss",0,0,0,0,0,0,1,"DataOne",1,0,0,1
"ssv-qpc-09",0,0,0,0,0,0,1,"DataOne",1,0,0,1
"standard deviation",0,0,0,0,0,0,1,"DataOne",1,0,0,1
"standard units (su)",0,0,0,0,0,0,1,"DataOne",1,0,0,1
"standing",0,0,0,0,0,0,1,"DataOne",1,0,0,1
"standing up",0,0,0,0,0,0,1,"DataOne",1,0,0,1
"station number",0,0,0,0,0,0,1,"DataOne",1,0,0,1
"std dev",0,0,0,0,0,0,1,"DataOne",1,0,0,1
"std err mean",0,0,0,0,0,0,1,"DataOne",1,0,0,1
"steelhead trout",0,0,0,0,0,0,1,"DataOne",1,0,0,1
"stetson1936",0,0,0,0,0,0,1,"DataOne",1,0,0,1
"stetson1938",0,0,0,0,0,0,1,"DataOne",1,0,0,1
"sticking head into water",0,0,0,0,0,0,1,"DataOne",1,0,0,1
"sticking head out of water",0,0,0,0,0,0,1,"DataOne",1,0,0,1
"stickley run member",0,0,0,0,0,0,1,"DataOne",1,0,0,1
"stillaguamish",0,0,0,0,0,0,1,"DataOne",1,0,0,1
"stone bridge",0,0,0,0,0,0,1,"DataOne",1,0,0,1
"stonehenge limestone",0,0,0,0,0,0,1,"DataOne",1,0,0,1
"storage",0,0,0,0,0,0,1,"DataOne",1,0,0,1
"storm-induced scour",0,0,0,0,0,0,1,"DataOne",1,0,0,1
"stratigraphic test",0,0,0,0,0,0,1,"DataOne",1,0,0,1
"stream",0,0,0,0,0,0,1,"DataOne",1,0,0,1
"strip mine",0,0,0,0,0,0,1,"DataOne",1,0,0,1
"striped bass",0,0,0,0,0,0,1,"DataOne",1,0,0,1
"sts",0,0,0,0,0,0,1,"DataOne",1,0,0,1
"stsnf",0,0,0,0,0,0,1,"DataOne",1,0,0,1
"subadult",0,0,0,0,0,0,1,"DataOne",1,0,0,1
"subadult (adolescent)",0,0,0,0,0,0,1,"DataOne",1,0,0,1
"suberites sp.",0,0,0,0,0,0,1,"DataOne",1,0,0,1
"submergent and emergent macrophytes",0,0,0,0,0,0,1,"DataOne",1,0,0,1
"submergent macrophytes",0,0,0,0,0,0,1,"DataOne",1,0,0,1
"subsequent sampling interval after first confirmation of wns",0,0,0,0,0,0,1,"DataOne",1,0,0,1
"sudley springs",0,0,0,0,0,0,1,"DataOne",1,0,0,1
"suisun",0,0,0,0,0,0,1,"DataOne",1,0,0,1
"suliformes",0,0,0,0,0,0,1,"DataOne",1,0,0,1
"summit gabbro",0,0,0,0,0,0,1,"DataOne",1,0,0,1
"summit meadow",0,0,0,0,0,0,1,"DataOne",1,0,0,1
"sunbury shale",0,0,0,0,0,0,1,"DataOne",1,0,0,1
"sunny/clear",0,0,0,0,0,0,1,"DataOne",1,0,0,1
"surface grab",0,0,0,0,0,0,1,"DataOne",1,0,0,1
"survey h11922 in rhode island sound",0,0,0,0,0,0,1,"DataOne",1,0,0,1
"survey h11995 in rhode island sound",0,0,0,0,0,0,1,"DataOne",1,0,0,1
"survey h11996 in rhode island sound",0,0,0,0,0,0,1,"DataOne",1,0,0,1
"survey h11999",0,0,0,0,0,0,1,"DataOne",1,0,0,1
"survey h12007 in nantucket sound",0,0,0,0,0,0,1,"DataOne",1,0,0,1
"survey h12012 in long island sound",0,0,0,0,0,0,1,"DataOne",1,0,0,1
"survey h12013 in long island sound",0,0,0,0,0,0,1,"DataOne",1,0,0,1
"survey h12023 in northern block island sound",0,0,0,0,0,0,1,"DataOne",1,0,0,1
"survey h12298",0,0,0,0,0,0,1,"DataOne",1,0,0,1
"survey h12324",0,0,0,0,0,0,1,"DataOne",1,0,0,1
"susc",0,0,0,0,0,0,1,"DataOne",1,0,0,1
"suspended",0,0,0,0,0,0,1,"DataOne",1,0,0,1
"suspended sediment concentration, 80154",0,0,0,0,0,0,1,"DataOne",1,0,0,1
"susquehanna river (pa)",0,0,0,0,0,0,1,"DataOne",1,0,0,1
"sv",0,0,0,0,0,0,1,"DataOne",1,0,0,1
"swale",0,0,0,0,0,0,1,"DataOne",1,0,0,1
"swamp bay",0,0,0,0,0,0,1,"DataOne",1,0,0,1
"swamp dogwood",0,0,0,0,0,0,1,"DataOne",1,0,0,1
"swamp tupelo",0,0,0,0,0,0,1,"DataOne",1,0,0,1
"sweetgum",0,0,0,0,0,0,1,"DataOne",1,0,0,1
"swimming",0,0,0,0,0,0,1,"DataOne",1,0,0,1
"sy",0,0,0,0,0,0,1,"DataOne",1,0,0,1
"sycamore",0,0,0,0,0,0,1,"DataOne",1,0,0,1
"syenitic mylonite",0,0,0,0,0,0,1,"DataOne",1,0,0,1
"symbolized as <ftr_type>, but labeled <ftr_type>.",0,0,0,0,0,0,1,"DataOne",1,0,0,1
"syringe sample from box core",0,0,0,0,0,0,1,"DataOne",1,0,0,1
"syrphidae",0,0,0,0,0,0,1,"DataOne",1,0,0,1
"system id for this country",0,0,0,0,0,0,1,"DataOne",1,0,0,1
"system id for this state",0,0,0,0,0,0,1,"DataOne",1,0,0,1
"system number for this county",0,0,0,0,0,0,1,"DataOne",1,0,0,1
"t- 5",0,0,0,0,0,0,1,"DataOne",1,0,0,1
"t- 7",0,0,0,0,0,0,1,"DataOne",1,0,0,1
"ta",0,0,0,0,0,0,1,"DataOne",1,0,0,1
"ta_ppm_ms_st",0,0,0,0,0,0,1,"DataOne",1,0,0,1
"ta_ppm_na_lc",0,0,0,0,0,0,1,"DataOne",1,0,0,1
"ta_ppm_na_sc",0,0,0,0,0,0,1,"DataOne",1,0,0,1
"tabular",0,0,0,0,0,0,1,"DataOne",1,0,0,1
"tahuya",0,0,0,0,0,0,1,"DataOne",1,0,0,1
"tailings - dredge",0,0,0,0,0,0,1,"DataOne",1,0,0,1
"tailings - mill",0,0,0,0,0,0,1,"DataOne",1,0,0,1
"tailings - placer",0,0,0,0,0,0,1,"DataOne",1,0,0,1
"tailings - pond",0,0,0,0,0,0,1,"DataOne",1,0,0,1
"tailings - undifferentiated",0,0,0,0,0,0,1,"DataOne",1,0,0,1
"talon",0,0,0,0,0,0,1,"DataOne",1,0,0,1
"tan",0,0,0,0,0,0,1,"DataOne",1,0,0,1
"tanana river",0,0,0,0,0,0,1,"DataOne",1,0,0,1
"tb",0,0,0,0,0,0,1,"DataOne",1,0,0,1
"tb_ar",0,0,0,0,0,0,1,"DataOne",1,0,0,1
"tb_ppm_ms_st",0,0,0,0,0,0,1,"DataOne",1,0,0,1
"tb_ppm_ms_st_ree",0,0,0,0,0,0,1,"DataOne",1,0,0,1
"tb_ppm_na_lc",0,0,0,0,0,0,1,"DataOne",1,0,0,1
"tb_ppm_na_sc",0,0,0,0,0,0,1,"DataOne",1,0,0,1
"tbu",0,0,0,0,0,0,1,"DataOne",1,0,0,1
"tc",0,0,0,0,0,0,1,"DataOne",1,0,0,1
"tc_jrm",0,0,0,0,0,0,1,"DataOne",1,0,0,1
"te",0,0,0,0,0,0,1,"DataOne",1,0,0,1
"te_ppm_aa_gf_hbr",0,0,0,0,0,0,1,"DataOne",1,0,0,1
"te_ppm_ms_st",0,0,0,0,0,0,1,"DataOne",1,0,0,1
"teledyne rdi waves software package",0,0,0,0,0,0,1,"DataOne",1,0,0,1
"temp",0,0,0,0,0,0,1,"DataOne",1,0,0,1
"temple basin",0,0,0,0,0,0,1,"DataOne",1,0,0,1
"temporarily flooded",0,0,0,0,0,0,1,"DataOne",1,0,0,1
"temporarily flooded shrubs",0,0,0,0,0,0,1,"DataOne",1,0,0,1
"terrestrial",0,0,0,0,0,0,1,"DataOne",1,0,0,1
"terrestrial",0,0,0,0,0,0,1,"DataOne",1,0,0,1
"territory",0,0,0,0,0,0,1,"DataOne",1,0,0,1
"tertiary - rocks of the black mingo group",0,0,0,0,0,0,1,"DataOne",1,0,0,1
"tessellated darter",0,0,0,0,0,0,1,"DataOne",1,0,0,1
"text",0,0,0,0,0,0,1,"DataOne",1,0,0,1
"tf",0,0,0,0,0,0,1,"DataOne",1,0,0,1
"tfs",0,0,0,0,0,0,1,"DataOne",1,0,0,1
"tg&b marine moonpool boat",0,0,0,0,0,0,1,"DataOne",1,0,0,1
"tgp70",0,0,0,0,0,0,1,"DataOne",1,0,0,1
"th",0,0,0,0,0,0,1,"DataOne",1,0,0,1
"th_ppm_dn",0,0,0,0,0,0,1,"DataOne",1,0,0,1
"th_ppm_es_sq",0,0,0,0,0,0,1,"DataOne",1,0,0,1
"th_ppm_ms_st",0,0,0,0,0,0,1,"DataOne",1,0,0,1
"th_ppm_na_lc",0,0,0,0,0,0,1,"DataOne",1,0,0,1
"th_ppm_na_sc",0,0,0,0,0,0,1,"DataOne",1,0,0,1
"thaleichthys pacificus",0,0,0,0,0,0,1,"DataOne",1,0,0,1
"the nature conservancy",0,0,0,0,0,0,1,"DataOne",1,0,0,1
"the number of detections of the constituent in field blank samples evaluated for the initial sampling period.",0,0,0,0,0,0,1,"DataOne",1,0,0,1
"the number of detections of the constituent in field blank samples evaluated for the trend sampling period.",0,0,0,0,0,0,1,"DataOne",1,0,0,1
"the number of field blank samples collected and analyzed for the constituent around the trend sampling period.",0,0,0,0,0,0,1,"DataOne",1,0,0,1
"the number of field blank samples collected and analyzed for the constituent during the initial sampling period.",0,0,0,0,0,0,1,"DataOne",1,0,0,1
"the number of laboratory-matrix spike samples of the constituent evaluated for the initial sampling period.",0,0,0,0,0,0,1,"DataOne",1,0,0,1
"the number of laboratory-matrix spike samples of the constituent evaluated for the trend sampling period.",0,0,0,0,0,0,1,"DataOne",1,0,0,1
"the number of replicate samples evaluated for the initial sampling period for which the constituent was detected in both the primary groundwater sample and its duplicate.",0,0,0,0,0,0,1,"DataOne",1,0,0,1
"the number of replicate samples evaluated for the trend sampling period for which the constituent was detected in both the primary groundwater sample and its duplicate.",0,0,0,0,0,0,1,"DataOne",1,0,0,1
"the number of replicate samples of the constituent evaluated for the initial sampling period.",0,0,0,0,0,0,1,"DataOne",1,0,0,1
"the year and season of sample collection: 1 = winter, 2 = spring, 3 = summer, 4 = fall",0,0,0,0,0,0,1,"DataOne",1,0,0,1
"themisto libellula",0,0,0,0,0,0,1,"DataOne",1,0,0,1
"thick sed",0,0,0,0,0,0,1,"DataOne",1,0,0,1
"thieler",0,0,0,0,0,0,1,"DataOne",1,0,0,1
"thin sed",0,0,0,0,0,0,1,"DataOne",1,0,0,1
"thunder",0,0,0,0,0,0,1,"DataOne",1,0,0,1
"thysanoessa  inermis",0,0,0,0,0,0,1,"DataOne",1,0,0,1
"thysanoessa raschii",0,0,0,0,0,0,1,"DataOne",1,0,0,1
"thysanoessa sp.",0,0,0,0,0,0,1,"DataOne",1,0,0,1
"thysanoessa spinifera",0,0,0,0,0,0,1,"DataOne",1,0,0,1
"ti",0,0,0,0,0,0,1,"DataOne",1,0,0,1
"ti_pct_aes_st",0,0,0,0,0,0,1,"DataOne",1,0,0,1
"ti_pct_es_sq",0,0,0,0,0,0,1,"DataOne",1,0,0,1
"ti_pct_wdx_fuse",0,0,0,0,0,0,1,"DataOne",1,0,0,1
"tidal delta",0,0,0,0,0,0,1,"DataOne",1,0,0,1
"tillamook",0,0,0,0,0,0,1,"DataOne",1,0,0,1
"tilloid",0,0,0,0,0,0,1,"DataOne",1,0,0,1
"time",0,0,0,0,0,0,1,"DataOne",1,0,0,1
"time (hhmm)",0,0,0,0,0,0,1,"DataOne",1,0,0,1
"time in utc (hour:minute:second)",0,0,0,0,0,0,1,"DataOne",1,0,0,1
"time, in hhmmss",0,0,0,0,0,0,1,"DataOne",1,0,0,1
"tio2",0,0,0,0,0,0,1,"DataOne",1,0,0,1
"tio2_pct_wdx_fuse",0,0,0,0,0,0,1,"DataOne",1,0,0,1
"tipulidae",0,0,0,0,0,0,1,"DataOne",1,0,0,1
"tissue",0,0,0,0,0,0,1,"DataOne",1,0,0,1
"tl",0,0,0,0,0,0,1,"DataOne",1,0,0,1
"tl_ppm_ms_st",0,0,0,0,0,0,1,"DataOne",1,0,0,1
"tlr-04",0,0,0,0,0,0,1,"DataOne",1,0,0,1
"tm_ppm_ms_st",0,0,0,0,0,0,1,"DataOne",1,0,0,1
"tm_ppm_ms_st_ree",0,0,0,0,0,0,1,"DataOne",1,0,0,1
"tog",0,0,0,0,0,0,1,"DataOne",1,0,0,1
"toksook bay, y-k delta",0,0,0,0,0,0,1,"DataOne",1,0,0,1
"tonalite",0,0,0,0,0,0,1,"DataOne",1,0,0,1
"tonoloway limestone",0,0,0,0,0,0,1,"DataOne",1,0,0,1
"top",0,0,0,0,0,0,1,"DataOne",1,0,0,1
"tora2",0,0,0,0,0,0,1,"DataOne",1,0,0,1
"total nitrogen, 00600",0,0,0,0,0,0,1,"DataOne",1,0,0,1
"total participants in 2014",0,0,0,0,0,0,1,"DataOne",1,0,0,1
"total phosphorus, 00665",0,0,0,0,0,0,1,"DataOne",1,0,0,1
"tr",0,0,0,0,0,0,1,"DataOne",1,0,0,1
"tr",0,0,0,0,0,0,1,"DataOne",1,0,0,1
"tr-009",0,0,0,0,0,0,1,"DataOne",1,0,0,1
"tr-018",0,0,0,0,0,0,1,"DataOne",1,0,0,1
"transverse sand waves",0,0,0,0,0,0,1,"DataOne",1,0,0,1
"transverse sand waves",0,0,0,0,0,0,1,"DataOne",1,0,0,1
"trap",0,0,0,0,0,0,1,"DataOne",1,0,0,1
"trauma",0,0,0,0,0,0,1,"DataOne",1,0,0,1
"trawl marks",0,0,0,0,0,0,1,"DataOne",1,0,0,1
"trawlmark",0,0,0,0,0,0,1,"DataOne",1,0,0,1
"trawlmarks",0,0,0,0,0,0,1,"DataOne",1,0,0,1
"trawlmks",0,0,0,0,0,0,1,"DataOne",1,0,0,1
"trcy-03",0,0,0,0,0,0,1,"DataOne",1,0,0,1
"treatment",0,0,0,0,0,0,1,"DataOne",1,0,0,1
"trench",0,0,0,0,0,0,1,"DataOne",1,0,0,1
"trichoptera",0,0,0,0,0,0,1,"DataOne",1,0,0,1
"trigger-weight core",0,0,0,0,0,0,1,"DataOne",1,0,0,1
"triopsidae",0,0,0,0,0,0,1,"DataOne",1,0,0,1
"trlk-02",0,0,0,0,0,0,1,"DataOne",1,0,0,1
"troy ounce / short ton",0,0,0,0,0,0,1,"DataOne",1,0,0,1
"troy ounce per short ton",0,0,0,0,0,0,1,"DataOne",1,0,0,1
"true",0,0,0,0,0,0,1,"DataOne",1,0,0,1
"ts",0,0,0,0,0,0,1,"DataOne",1,0,0,1
"ts for kl",0,0,0,0,0,0,1,"DataOne",1,0,0,1
"ts for rh",0,0,0,0,0,0,1,"DataOne",1,0,0,1
"tt",0,0,0,0,0,0,1,"DataOne",1,0,0,1
"tt_kno3",0,0,0,0,0,0,1,"DataOne",1,0,0,1
"tu",0,0,0,0,0,0,1,"DataOne",1,0,0,1
"tualatin hills park and rec district",0,0,0,0,0,0,1,"DataOne",1,0,0,1
"tualatin river keepers",0,0,0,0,0,0,1,"DataOne",1,0,0,1
"tule-01",0,0,0,0,0,0,1,"DataOne",1,0,0,1
"tully limestone",0,0,0,0,0,0,1,"DataOne",1,0,0,1
"tundering",0,0,0,0,0,0,1,"DataOne",1,0,0,1
"tundrius",0,0,0,0,0,0,1,"DataOne",1,0,0,1
"turkey antalya",0,0,0,0,0,0,1,"DataOne",1,0,0,1
"twa particle density (mg/m3)",0,0,0,0,0,0,1,"DataOne",1,0,0,1
"twichell",0,0,0,0,0,0,1,"DataOne",1,0,0,1
"typically two branches per node",0,0,0,0,0,0,1,"DataOne",1,0,0,1
"u-seimens",0,0,0,0,0,0,1,"DataOne",1,0,0,1
"u_ppm_dn",0,0,0,0,0,0,1,"DataOne",1,0,0,1
"u_ppm_ms_st",0,0,0,0,0,0,1,"DataOne",1,0,0,1
"u_ppm_na_lc",0,0,0,0,0,0,1,"DataOne",1,0,0,1
"u_ppm_na_sc",0,0,0,0,0,0,1,"DataOne",1,0,0,1
"ua4",0,0,0,0,0,0,1,"DataOne",1,0,0,1
"ua5",0,0,0,0,0,0,1,"DataOne",1,0,0,1
"ua6",0,0,0,0,0,0,1,"DataOne",1,0,0,1
"ua7",0,0,0,0,0,0,1,"DataOne",1,0,0,1
"ug/cm2",0,0,0,0,0,0,1,"DataOne",1,0,0,1
"ug/kg",0,0,0,0,0,0,1,"DataOne",1,0,0,1
"ulasf-05",0,0,0,0,0,0,1,"DataOne",1,0,0,1
"ulasf-09",0,0,0,0,0,0,1,"DataOne",1,0,0,1
"ulasg-11",0,0,0,0,0,0,1,"DataOne",1,0,0,1
"ulasg-15",0,0,0,0,0,0,1,"DataOne",1,0,0,1
"umpd",0,0,0,0,0,0,1,"DataOne",1,0,0,1
"uncalibrated radiocarbon years",0,0,0,0,0,0,1,"DataOne",1,0,0,1
"undetermined",0,0,0,0,0,0,1,"DataOne",1,0,0,1
"unhd",0,0,0,0,0,0,1,"DataOne",1,0,0,1
"unitless erosion potential estimate",0,0,0,0,0,0,1,"DataOne",1,0,0,1
"unitless estimate of wave energy",0,0,0,0,0,0,1,"DataOne",1,0,0,1
"unitless ratio",0,0,0,0,0,0,1,"DataOne",1,0,0,1
"units correspond to month, day and year in the format mm/dd/yy",0,0,0,0,0,0,1,"DataOne",1,0,0,1
"units here",0,0,0,0,0,0,1,"DataOne",1,0,0,1
"unknown device",0,0,0,0,0,0,1,"DataOne",1,0,0,1
"unknown species",0,0,0,0,0,0,1,"DataOne",1,0,0,1
"unnamed western fork of paradise creek",0,0,0,0,0,0,1,"DataOne",1,0,0,1
"uno",0,0,0,0,0,0,1,"DataOne",1,0,0,1
"unopies",0,0,0,0,0,0,1,"DataOne",1,0,0,1
"unplowed winter-dry corn",0,0,0,0,0,0,1,"DataOne",1,0,0,1
"unplowed winter-dry rice",0,0,0,0,0,0,1,"DataOne",1,0,0,1
"unre",0,0,0,0,0,0,1,"DataOne",1,0,0,1
"unsh",0,0,0,0,0,0,1,"DataOne",1,0,0,1
"unsp",0,0,0,0,0,0,1,"DataOne",1,0,0,1
"unsure",0,0,0,0,0,0,1,"DataOne",1,0,0,1
"unvegetated",0,0,0,0,0,0,1,"DataOne",1,0,0,1
"upland",0,0,0,0,0,0,1,"DataOne",1,0,0,1
"upper 95% mean",0,0,0,0,0,0,1,"DataOne",1,0,0,1
"upper cambrian",0,0,0,0,0,0,1,"DataOne",1,0,0,1
"upper devonian",0,0,0,0,0,0,1,"DataOne",1,0,0,1
"upper ordovician",0,0,0,0,0,0,1,"DataOne",1,0,0,1
"upperbeach",0,0,0,0,0,0,1,"DataOne",1,0,0,1
"uranium mine",0,0,0,0,0,0,1,"DataOne",1,0,0,1
"urs-00",0,0,0,0,0,0,1,"DataOne",1,0,0,1
"urs-01",0,0,0,0,0,0,1,"DataOne",1,0,0,1
"urs-99",0,0,0,0,0,0,1,"DataOne",1,0,0,1
"usa data",0,0,0,0,0,0,1,"DataOne",1,0,0,1
"usace",0,0,0,0,0,0,1,"DataOne",1,0,0,1
"uscg 41",0,0,0,0,0,0,1,"DataOne",1,0,0,1
"uscm-1, microsiemens per centimeter",0,0,0,0,0,0,1,"DataOne",1,0,0,1
"usfws-pacific island",0,0,0,0,0,0,1,"DataOne",1,0,0,1
"usgs-99",0,0,0,0,0,0,1,"DataOne",1,0,0,1
"usgs-bgc",0,0,0,0,0,0,1,"DataOne",1,0,0,1
"usgs-state cooperative study",0,0,0,0,0,0,1,"DataOne",1,0,0,1
"usgs-wrd",0,0,0,0,0,0,1,"DataOne",1,0,0,1
"usgs csg",0,0,0,0,0,0,1,"DataOne",1,0,0,1
"usgs slow corer",0,0,0,0,0,0,1,"DataOne",1,0,0,1
"usnm",0,0,0,0,0,0,1,"DataOne",1,0,0,1
"utah",0,0,0,0,0,0,1,"DataOne",1,0,0,1
"utc",0,0,0,0,0,0,1,"DataOne",1,0,0,1
"utc (yyyymmddhhmmssz)",0,0,0,0,0,0,1,"DataOne",1,0,0,1
"utc yyyymmddhhmmss",0,0,0,0,0,0,1,"DataOne",1,0,0,1
"utm zone",0,0,0,0,0,0,1,"DataOne",1,0,0,1
"utpd",0,0,0,0,0,0,1,"DataOne",1,0,0,1
"v_ppm_aes_st",0,0,0,0,0,0,1,"DataOne",1,0,0,1
"v_ppm_es_sq",0,0,0,0,0,0,1,"DataOne",1,0,0,1
"v_ppm_wdx_fuse",0,0,0,0,0,0,1,"DataOne",1,0,0,1
"valentine",0,0,0,0,0,0,1,"DataOne",1,0,0,1
"van veen",0,0,0,0,0,0,1,"DataOne",1,0,0,1
"van veen grab - teflon coated",0,0,0,0,0,0,1,"DataOne",1,0,0,1
"vanveen",0,0,0,0,0,0,1,"DataOne",1,0,0,1
"vanveen",0,0,0,0,0,0,1,"DataOne",1,0,0,1
"vanveen grab",0,0,0,0,0,0,1,"DataOne",1,0,0,1
"var",0,0,0,0,0,0,1,"DataOne",1,0,0,1
"variable units",0,0,0,0,0,0,1,"DataOne",1,0,0,1
"various",0,0,0,0,0,0,1,"DataOne",1,0,0,1
"vbc",0,0,0,0,0,0,1,"DataOne",1,0,0,1
"vc",0,0,0,0,0,0,1,"DataOne",1,0,0,1
"vector",0,0,0,0,0,0,1,"DataOne",1,0,0,1
"vegematic box core",0,0,0,0,0,0,1,"DataOne",1,0,0,1
"vegetated",0,0,0,0,0,0,1,"DataOne",1,0,0,1
"vehicle",0,0,0,0,0,0,1,"DataOne",1,0,0,1
"vereshchagin",0,0,0,0,0,0,1,"DataOne",1,0,0,1
"very coarse gravel",0,0,0,0,0,0,1,"DataOne",1,0,0,1
"very far",0,0,0,0,0,0,1,"DataOne",1,0,0,1
"very fine gravel",0,0,0,0,0,0,1,"DataOne",1,0,0,1
"very high",0,0,0,0,0,0,1,"DataOne",1,0,0,1
"very high heat load",0,0,0,0,0,0,1,"DataOne",1,0,0,1
"very low",0,0,0,0,0,0,1,"DataOne",1,0,0,1
"very low heat load",0,0,0,0,0,0,1,"DataOne",1,0,0,1
"very windy",0,0,0,0,0,0,1,"DataOne",1,0,0,1
"vipera berus",0,0,0,0,0,0,1,"DataOne",1,0,0,1
"virgin basin",0,0,0,0,0,0,1,"DataOne",1,0,0,1
"virginia",0,0,0,0,0,0,1,"DataOne",1,0,0,1
"visit number",0,0,0,0,0,0,1,"DataOne",1,0,0,1
"visitor",0,0,0,0,0,0,1,"DataOne",1,0,0,1
"vol",0,0,0,0,0,0,1,"DataOne",1,0,0,1
"volts 360",0,0,0,0,0,0,1,"DataOne",1,0,0,1
"volts 380",0,0,0,0,0,0,1,"DataOne",1,0,0,1
"volts 410",0,0,0,0,0,0,1,"DataOne",1,0,0,1
"volume percent",0,0,0,0,0,0,1,"DataOne",1,0,0,1
"vv",0,0,0,0,0,0,1,"DataOne",1,0,0,1
"w_ppm_es_sq",0,0,0,0,0,0,1,"DataOne",1,0,0,1
"w_ppm_ms_st",0,0,0,0,0,0,1,"DataOne",1,0,0,1
"w2",0,0,0,0,0,0,1,"DataOne",1,0,0,1
"wac",0,0,0,0,0,0,1,"DataOne",1,0,0,1
"wader",0,0,0,0,0,0,1,"DataOne",1,0,0,1
"wading in water",0,0,0,0,0,0,1,"DataOne",1,0,0,1
"wal",0,0,0,0,0,0,1,"DataOne",1,0,0,1
"walking",0,0,0,0,0,0,1,"DataOne",1,0,0,1
"wardetal01",0,0,0,0,0,0,1,"DataOne",1,0,0,1
"water elm",0,0,0,0,0,0,1,"DataOne",1,0,0,1
"water oak",0,0,0,0,0,0,1,"DataOne",1,0,0,1
"water sample",0,0,0,0,0,0,1,"DataOne",1,0,0,1
"water temp",0,0,0,0,0,0,1,"DataOne",1,0,0,1
"water tupelo",0,0,0,0,0,0,1,"DataOne",1,0,0,1
"waterborne cercaria",0,0,0,0,0,0,1,"DataOne",1,0,0,1
"waterfowl",0,0,0,0,0,0,1,"DataOne",1,0,0,1
"watts",0,0,0,0,0,0,1,"DataOne",1,0,0,1
"waxmyrtle",0,0,0,0,0,0,1,"DataOne",1,0,0,1
"wbc/ul",0,0,0,0,0,0,1,"DataOne",1,0,0,1
"wc",0,0,0,0,0,0,1,"DataOne",1,0,0,1
"wdx_hf",0,0,0,0,0,0,1,"DataOne",1,0,0,1
"wdx_pp",0,0,0,0,0,0,1,"DataOne",1,0,0,1
"wdx_raw",0,0,0,0,0,0,1,"DataOne",1,0,0,1
"week",0,0,0,0,0,0,1,"DataOne",1,0,0,1
"weight",0,0,0,0,0,0,1,"DataOne",1,0,0,1
"well",0,0,0,0,0,0,1,"DataOne",1,0,0,1
"well digested material",0,0,0,0,0,0,1,"DataOne",1,0,0,1
"well pad",0,0,0,0,0,0,1,"DataOne",1,0,0,1
"well pad residual disturbance",0,0,0,0,0,0,1,"DataOne",1,0,0,1
"west falls formation",0,0,0,0,0,0,1,"DataOne",1,0,0,1
"west virginia",0,0,0,0,0,0,1,"DataOne",1,0,0,1
"western prince william sound",0,0,0,0,0,0,1,"DataOne",1,0,0,1
"wet meadow shrub; 10-33% density",0,0,0,0,0,0,1,"DataOne",1,0,0,1
"wet meadow; > 90% density",0,0,0,0,0,0,1,"DataOne",1,0,0,1
"wet meadow; 10-33% density",0,0,0,0,0,0,1,"DataOne",1,0,0,1
"wet meadow; 33-66% density",0,0,0,0,0,0,1,"DataOne",1,0,0,1
"wet meadow; 66-90% density",0,0,0,0,0,0,1,"DataOne",1,0,0,1
"wet shrub",0,0,0,0,0,0,1,"DataOne",1,0,0,1
"wetland",0,0,0,0,0,0,1,"DataOne",1,0,0,1
"whim",0,0,0,0,0,0,1,"DataOne",1,0,0,1
"whisky",0,0,0,0,0,0,1,"DataOne",1,0,0,1
"white crappie",0,0,0,0,0,0,1,"DataOne",1,0,0,1
"white heath",0,0,0,0,0,0,1,"DataOne",1,0,0,1
"white sucker",0,0,0,0,0,0,1,"DataOne",1,0,0,1
"whoi core storage facility",0,0,0,0,0,0,1,"DataOne",1,0,0,1
"whole",0,0,0,0,0,0,1,"DataOne",1,0,0,1
"whole blood",0,0,0,0,0,0,1,"DataOne",1,0,0,1
"whole counts",0,0,0,0,0,0,1,"DataOne",1,0,0,1
"whole species",0,0,0,0,0,0,1,"DataOne",1,0,0,1
"whs",0,0,0,0,0,0,1,"DataOne",1,0,0,1
"wica-rm",0,0,0,0,0,0,1,"DataOne",1,0,0,1
"wigley1961",0,0,0,0,0,0,1,"DataOne",1,0,0,1
"wigley1965",0,0,0,0,0,0,1,"DataOne",1,0,0,1
"willett1972",0,0,0,0,0,0,1,"DataOne",1,0,0,1
"wills creek formation",0,0,0,0,0,0,1,"DataOne",1,0,0,1
"wind",0,0,0,0,0,0,1,"DataOne",1,0,0,1
"wind; rain?",0,0,0,0,0,0,1,"DataOne",1,0,0,1
"winters",0,0,0,0,0,0,1,"DataOne",1,0,0,1
"wisconsin",0,0,0,0,0,0,1,"DataOne",1,0,0,1
"wma",0,0,0,0,0,0,1,"DataOne",1,0,0,1
"wmb",0,0,0,0,0,0,1,"DataOne",1,0,0,1
"wmc",0,0,0,0,0,0,1,"DataOne",1,0,0,1
"wmd",0,0,0,0,0,0,1,"DataOne",1,0,0,1
"wmsa",0,0,0,0,0,0,1,"DataOne",1,0,0,1
"wood",0,0,0,0,0,0,1,"DataOne",1,0,0,1
"wood biomass increment",0,0,0,0,0,0,1,"DataOne",1,0,0,1
"woods hole harbor",0,0,0,0,0,0,1,"DataOne",1,0,0,1
"woodyshrub",0,0,0,0,0,0,1,"DataOne",1,0,0,1
"worms",0,0,0,0,0,0,1,"DataOne",1,0,0,1
"wr",0,0,0,0,0,0,1,"DataOne",1,0,0,1
"wrecks",0,0,0,0,0,0,1,"DataOne",1,0,0,1
"ws-02",0,0,0,0,0,0,1,"DataOne",1,0,0,1
"wtpd",0,0,0,0,0,0,1,"DataOne",1,0,0,1
"wtsh",0,0,0,0,0,0,1,"DataOne",1,0,0,1
"ww",0,0,0,0,0,0,1,"DataOne",1,0,0,1
"wwsc",0,0,0,0,0,0,1,"DataOne",1,0,0,1
"wymps gap member",0,0,0,0,0,0,1,"DataOne",1,0,0,1
"x",0,0,0,0,0,0,1,"DataOne",1,0,0,1
"xerophytic vegetation",0,0,0,0,0,0,1,"DataOne",1,0,0,1
"xl",0,0,0,0,0,0,1,"DataOne",1,0,0,1
"xrd",0,0,0,0,0,0,1,"DataOne",1,0,0,1
"xrf",0,0,0,0,0,0,1,"DataOne",1,0,0,1
"xs",0,0,0,0,0,0,1,"DataOne",1,0,0,1
"y, 2 strains a+b",0,0,0,0,0,0,1,"DataOne",1,0,0,1
"y, n. na",0,0,0,0,0,0,1,"DataOne",1,0,0,1
"y_ppm_edx",0,0,0,0,0,0,1,"DataOne",1,0,0,1
"y_ppm_es_sq",0,0,0,0,0,0,1,"DataOne",1,0,0,1
"y_ppm_ms_st",0,0,0,0,0,0,1,"DataOne",1,0,0,1
"yalik point",0,0,0,0,0,0,1,"DataOne",1,0,0,1
"yao",0,0,0,0,0,0,1,"DataOne",1,0,0,1
"yb",0,0,0,0,0,0,1,"DataOne",1,0,0,1
"yb_ppm_ms_st",0,0,0,0,0,0,1,"DataOne",1,0,0,1
"yb_ppm_ms_st_ree",0,0,0,0,0,0,1,"DataOne",1,0,0,1
"yb_ppm_na_lc",0,0,0,0,0,0,1,"DataOne",1,0,0,1
"yb_ppm_na_sc",0,0,0,0,0,0,1,"DataOne",1,0,0,1
"year: year of lake freezing, yyyy",0,0,0,0,0,0,1,"DataOne",1,0,0,1
"years starting with 1 = 2010 and 7 = 2016",0,0,0,0,0,0,1,"DataOne",1,0,0,1
"years.",0,0,0,0,0,0,1,"DataOne",1,0,0,1
"yellow perch",0,0,0,0,0,0,1,"DataOne",1,0,0,1
"yellowstone river",0,0,0,0,0,0,1,"DataOne",1,0,0,1
"yo",0,0,0,0,0,0,1,"DataOne",1,0,0,1
"yol-01",0,0,0,0,0,0,1,"DataOne",1,0,0,1
"yol-03",0,0,0,0,0,0,1,"DataOne",1,0,0,1
"yoy",0,0,0,0,0,0,1,"DataOne",1,0,0,1
"yoycapelin",0,0,0,0,0,0,1,"DataOne",1,0,0,1
"yoyherring",0,0,0,0,0,0,1,"DataOne",1,0,0,1
"yoypollock",0,0,0,0,0,0,1,"DataOne",1,0,0,1
"yr",0,0,0,0,0,0,1,"DataOne",1,0,0,1
"yr a.d.",0,0,0,0,0,0,1,"DataOne",1,0,0,1
"yuk",0,0,0,0,0,0,1,"DataOne",1,0,0,1
"yukon",0,0,0,0,0,0,1,"DataOne",1,0,0,1
"yukon-charley",0,0,0,0,0,0,1,"DataOne",1,0,0,1
"yukon river",0,0,0,0,0,0,1,"DataOne",1,0,0,1
"zetts fish hatchery (pa)",0,0,0,0,0,0,1,"DataOne",1,0,0,1
"zimmerman72",0,0,0,0,0,0,1,"DataOne",1,0,0,1
"zn",0,0,0,0,0,0,1,"DataOne",1,0,0,1
"zn_ppm_aes_az_p",0,0,0,0,0,0,1,"DataOne",1,0,0,1
"zn_ppm_aes_st",0,0,0,0,0,0,1,"DataOne",1,0,0,1
"zn_ppm_edx",0,0,0,0,0,0,1,"DataOne",1,0,0,1
"zn_ppm_es_sq",0,0,0,0,0,0,1,"DataOne",1,0,0,1
"zn_ppm_na_lc",0,0,0,0,0,0,1,"DataOne",1,0,0,1
"zn_ppm_na_sc",0,0,0,0,0,0,1,"DataOne",1,0,0,1
"zooplankton",0,0,0,0,0,0,1,"DataOne",1,0,0,1
"zr",0,0,0,0,0,0,1,"DataOne",1,0,0,1
"zr_ppm_aes_st",0,0,0,0,0,0,1,"DataOne",1,0,0,1
"zr_ppm_edx",0,0,0,0,0,0,1,"DataOne",1,0,0,1
"zr_ppm_es_sq",0,0,0,0,0,0,1,"DataOne",1,0,0,1
"zr_ppm_na_lc",0,0,0,0,0,0,1,"DataOne",1,0,0,1
"zr_ppm_na_sc",0,0,0,0,0,0,1,"DataOne",1,0,0,1
